# LANG=zh_TW
一上場	ㄧ ㄕㄤˋ ㄔㄤˇ
一上場	ㄧˊ ㄕㄤˋ ㄔㄤˇ
一世紀	ㄧ ㄕˋ ㄐㄧˋ
一世紀	ㄧˊ ㄕˋ ㄐㄧˋ
一五一十	ㄧ ㄨˇ ㄧ ㄕˊ
一位數	ㄧ ㄨㄟˋ ㄕㄨˋ
一位數	ㄧˊ ㄨㄟˋ ㄕㄨˋ
一個個	ㄧ ㄍㄜˋ ㄍㄜˋ
一個個	ㄧˊ ㄍㄜˋ ㄍㄜˋ
一個樣	ㄧ ㄍㄜˋ ㄧㄤˋ
一個樣	ㄧˊ ㄍㄜ˙ ㄧㄤˋ
一出場	ㄧ ㄔㄨ ㄔㄤˇ
一出場	ㄧˋ ㄔㄨ ㄔㄤˇ
一品鍋	ㄧ ㄆㄧㄣˇ ㄍㄨㄛ
一品鍋	ㄧˋ ㄆㄧㄣˇ ㄍㄨㄛ
一堂課	ㄧ ㄊㄤˊ ㄎㄜˋ
一堂課	ㄧˋ ㄊㄤˊ ㄎㄜˋ
一夔已足	ㄧ ㄎㄨㄟˊ ㄧˇ ㄗㄨˊ
一夔已足	ㄧˋ ㄎㄨㄟˊ ㄧˇ ㄗㄨˊ
一套套	ㄧ ㄊㄠˋ ㄊㄠˋ
一套套	ㄧˊ ㄊㄠˋ ㄊㄠˋ
一字師	ㄧ ㄗˋ ㄕ
一字師	ㄧˊ ㄗˋ ㄕ
一寸光陰一寸金	ㄧ ㄘㄨㄣˋ ㄍㄨㄤ ㄧㄣ ㄧ ㄘㄨㄣˋ ㄐㄧㄣ
一寸光陰一寸金	ㄧ ㄘㄨㄣˋ ㄍㄨㄤ ㄧㄣ ㄧˊ ㄘㄨㄣˋ ㄐㄧㄣ
一寸光陰一寸金	ㄧˊ ㄘㄨㄣˋ ㄍㄨㄤ ㄧㄣ ㄧ ㄘㄨㄣˋ ㄐㄧㄣ
一寸光陰一寸金	ㄧˊ ㄘㄨㄣˋ ㄍㄨㄤ ㄧㄣ ㄧˊ ㄘㄨㄣˋ ㄐㄧㄣ
一屁股	ㄧ ㄆㄧˋ ㄍㄨˇ
一屁股	ㄧˊ ㄆㄧˋ ㄍㄨˇ
一時一刻	ㄧ ㄕˊ ㄧ ㄎㄜˋ
一時一刻	ㄧ ㄕˊ ㄧˊ ㄎㄜˋ
一時一刻	ㄧˋ ㄕˊ ㄧ ㄎㄜˋ
一時一刻	ㄧˋ ㄕˊ ㄧˊ ㄎㄜˋ
一望無垠	ㄧ ㄨㄤˋ ㄨˊ ㄧㄣˊ
一望無垠	ㄧˊ ㄨㄤˋ ㄨˊ ㄧㄣˊ
一望無際	ㄧ ㄨㄤˋ ㄨˊ ㄐㄧˋ
一望無際	ㄧˊ ㄨㄤˋ ㄨˊ ㄐㄧˋ
一根根	ㄧ ㄍㄣ ㄍㄣ
一根根	ㄧˋ ㄍㄣ ㄍㄣ
一條條	ㄧ ㄊㄧㄠˊ ㄊㄧㄠˊ
一條條	ㄧˋ ㄊㄧㄠˊ ㄊㄧㄠˊ
一梯次	ㄧ ㄊㄧ ㄘˋ
一梯次	ㄧˋ ㄊㄧ ㄘˋ
一模一樣	ㄧ ㄇㄛˊ ㄧ ㄧㄤˋ
一模一樣	ㄧˋ ㄇㄛˊ ㄧˊ ㄧㄤˋ
一樣可以	ㄧ ㄧㄤˋ ㄎㄜˇ ㄧˇ
一樣可以	ㄧˊ ㄧㄤˋ ㄎㄜˇ ㄧˇ
一樣是	ㄧ ㄧㄤˋ ㄕˋ
一樣是	ㄧˊ ㄧㄤˋ ㄕˋ
一次次	ㄧ ㄘˋ ㄘˋ
一次次	ㄧˊ ㄘˋ ㄘˋ
一池春水	ㄧ ㄔˊ ㄔㄨㄣ ㄕㄨㄟˇ
一池春水	ㄧˋ ㄔˊ ㄔㄨㄣ ㄕㄨㄟˇ
一無是處	ㄧ ㄨˊ ㄕˋ ㄔㄨˋ
一無是處	ㄧˋ ㄨˊ ㄕˋ ㄔㄨˋ
一物剋一物	ㄧ ㄨˋ ㄎㄜˋ ㄧ ㄨˋ
一物剋一物	ㄧ ㄨˋ ㄎㄜˋ ㄧˊ ㄨˋ
一物剋一物	ㄧˊ ㄨˋ ㄎㄜˋ ㄧ ㄨˋ
一物剋一物	ㄧˊ ㄨˋ ㄎㄜˋ ㄧˊ ㄨˋ
一神教	ㄧ ㄕㄣˊ ㄐㄧㄠˋ
一神教	ㄧˋ ㄕㄣˊ ㄐㄧㄠˋ
一缸水	ㄧ ㄍㄤ ㄕㄨㄟˇ
一缸水	ㄧˋ ㄍㄤ ㄕㄨㄟˇ
一草一木	ㄧ ㄘㄠˇ ㄧ ㄇㄨˋ
一草一木	ㄧ ㄘㄠˇ ㄧˊ ㄇㄨˋ
一草一木	ㄧˋ ㄘㄠˇ ㄧ ㄇㄨˋ
一草一木	ㄧˋ ㄘㄠˇ ㄧˊ ㄇㄨˋ
一說出	ㄧ ㄕㄨㄛ ㄔㄨ
一說出	ㄧˋ ㄕㄨㄛ ㄔㄨ
一說起	ㄧ ㄕㄨㄛ ㄑㄧˇ
一說起	ㄧˋ ㄕㄨㄛ ㄑㄧˇ
一講出	ㄧ ㄐㄧㄤˇ ㄔㄨ
一講出	ㄧˋ ㄐㄧㄤˇ ㄔㄨ
一蹴可及	ㄧ ㄘㄨˋ ㄎㄜˇ ㄐㄧˊ
一蹴可及	ㄧˊ ㄘㄨˋ ㄎㄜˇ ㄐㄧˊ
一蹴可幾	ㄧ ㄘㄨˋ ㄎㄜˇ ㄐㄧ
一蹴可幾	ㄧˊ ㄘㄨˋ ㄎㄜˇ ㄐㄧ
一車子	ㄧ ㄔㄜ ㄗ˙
一車子	ㄧˋ ㄔㄜ ㄗ˙
一雙雙	ㄧ ㄕㄨㄤ ㄕㄨㄤ
一雙雙	ㄧˋ ㄕㄨㄤ ㄕㄨㄤ
一鼓作氣	ㄧ ㄍㄨˇ ㄗㄨㄛˋ ㄑㄧˋ
一鼓作氣	ㄧˋ ㄍㄨˇ ㄗㄨㄛˋ ㄑㄧˋ
七位數	ㄑㄧ ㄨㄟˋ ㄕㄨˋ
七梯次	ㄑㄧ ㄊㄧ ㄘˋ
上古史	ㄕㄤˋ ㄍㄨˇ ㄕˇ
上床睡覺	ㄕㄤˋ ㄔㄨㄤˊ ㄕㄨㄟˋ ㄐㄧㄠˋ
上意識	ㄕㄤˋ ㄧˋ ㄕˋ
上藥膏	ㄕㄤˋ ㄧㄠˋ ㄍㄠ
上課時	ㄕㄤˋ ㄎㄜˋ ㄕˊ
上課時數	ㄕㄤˋ ㄎㄜˋ ㄕˊ ㄕㄨˋ
上車時	ㄕㄤˋ ㄔㄜ ㄕˊ
上銀幕	ㄕㄤˋ ㄧㄣˊ ㄇㄨˋ
上顎骨	ㄕㄤˋ ㄜˋ ㄍㄨˇ
世出世	ㄕˋ ㄔㄨ ㄕˋ
世紀末	ㄕˋ ㄐㄧˋ ㄇㄛˋ
么么唱唱	ㄧㄠ ㄧㄠ ㄔㄤˋ ㄔㄤˋ
事事物物	ㄕˋ ㄕˋ ㄨˋ ㄨˋ
事務股	ㄕˋ ㄨˋ ㄍㄨˇ
事實上	ㄕˋ ㄕˊ ㄕㄤˋ
事實審	ㄕˋ ㄕˊ ㄕㄣˇ
五位數	ㄨˇ ㄨㄟˋ ㄕㄨˋ
五味子	ㄨˇ ㄨㄟˋ ㄗˇ
五子棋	ㄨˇ ㄗˇ ㄑㄧˊ
五臟廟	ㄨˇ ㄗㄤˋ ㄇㄧㄠˋ
五逆罪	ㄨˇ ㄋㄧˋ ㄗㄨㄟˋ
亡國奴	ㄨㄤˊ ㄍㄨㄛˊ ㄋㄨˊ
交割股	ㄐㄧㄠ ㄍㄜ ㄍㄨˇ
交往甚密	ㄐㄧㄠ ㄨㄤˇ ㄕㄣˋ ㄇㄧˋ
交易稅	ㄐㄧㄠ ㄧˋ ㄕㄨㄟˋ
交際舞	ㄐㄧㄠ ㄐㄧˋ ㄨˇ
什麼事	ㄕㄜˊ ㄇㄜ˙ ㄕˋ
以古況今	ㄧˇ ㄍㄨˇ ㄎㄨㄤˋ ㄐㄧㄣ
以為是	ㄧˇ ㄨㄟˊ ㄕˋ
以身作則	ㄧˇ ㄕㄣ ㄗㄨㄛˋ ㄗㄜˊ
以退為進	ㄧˇ ㄊㄨㄟˋ ㄨㄟˊ ㄐㄧㄣˋ
以進為退	ㄧˇ ㄐㄧㄣˋ ㄨㄟˊ ㄊㄨㄟˋ
仰臥起坐	ㄧㄤˇ ㄨㄛˋ ㄑㄧˇ ㄗㄨㄛˋ
伸伸腳	ㄕㄣ ㄕㄣ ㄐㄧㄠˇ
作圖器	ㄗㄨㄛˋ ㄊㄨˊ ㄑㄧˋ
作文課	ㄗㄨㄛˋ ㄨㄣˊ ㄎㄜˋ
你自己	ㄋㄧˇ ㄗˋ ㄐㄧˇ
使脾氣	ㄕˇ ㄆㄧˊ ㄑㄧˋ
依次是	ㄧ ㄘˋ ㄕˋ
俄文組	ㄜˊ ㄨㄣˊ ㄗㄨˇ
做什麼	ㄗㄨㄛˋ ㄕㄜˊ ㄇㄛˊ
做做事	ㄗㄨㄛˋ ㄗㄨㄛˋ ㄕˋ
做股票	ㄗㄨㄛˋ ㄍㄨˇ ㄆㄧㄠˋ
偽造品	ㄨㄟˋ ㄗㄠˋ ㄆㄧㄣˇ
偽造文書	ㄨㄟˋ ㄗㄠˋ ㄨㄣˊ ㄕㄨ
傷腦筋	ㄕㄤ ㄋㄠˇ ㄐㄧㄣ
僅僅是	ㄐㄧㄣˇ ㄐㄧㄣˇ ㄕˋ
儲存器	ㄔㄨˇ ㄘㄨㄣˊ ㄑㄧˋ
儲存室	ㄔㄨˇ ㄘㄨㄣˊ ㄕˋ
儲存庫	ㄔㄨˇ ㄘㄨㄣˊ ㄎㄨˋ
儲藏室	ㄔㄨˇ ㄘㄤˊ ㄕˋ
光禿禿	ㄍㄨㄤ ㄊㄨ ㄊㄨ
光譜儀	ㄍㄨㄤ ㄆㄨˇ ㄧˊ
內務櫃	ㄋㄟˋ ㄨˋ ㄍㄨㄟˋ
內衣褲	ㄋㄟˋ ㄧ ㄎㄨˋ
內錯角	ㄋㄟˋ ㄘㄨㄛˋ ㄐㄧㄠˇ
其實是	ㄑㄧˊ ㄕˊ ㄕˋ
其次是	ㄑㄧˊ ㄘˋ ㄕˋ
冒冒失失	ㄇㄠˋ ㄇㄠˋ ㄕ ㄕ
冒失鬼	ㄇㄠˋ ㄕ ㄍㄨㄟˇ
凹凹凸凸	ㄠ ㄠ ㄊㄨˊ ㄊㄨˊ
出出氣	ㄔㄨ ㄔㄨ ㄑㄧˋ
出出進進	ㄔㄨ ㄔㄨ ㄐㄧㄣˋ ㄐㄧㄣˋ
出國時	ㄔㄨ ㄍㄨㄛˊ ㄕˊ
出土文物	ㄔㄨ ㄊㄨˇ ㄨㄣˊ ㄨˋ
出操課	ㄔㄨ ㄘㄠ ㄎㄜˋ
出沒無常	ㄔㄨ ㄇㄛˋ ㄨˊ ㄔㄤˊ
出超國	ㄔㄨ ㄔㄠ ㄍㄨㄛˊ
出超額	ㄔㄨ ㄔㄠ ㄜˊ
出門時	ㄔㄨ ㄇㄣˊ ㄕˊ
刈草機	ㄧˋ ㄘㄠˇ ㄐㄧ
初校樣	ㄔㄨ ㄐㄧㄠˋ ㄧㄤˋ
初級社	ㄔㄨ ㄐㄧˊ ㄕㄜˋ
刺毛輥	ㄘˋ ㄇㄠˊ ㄍㄨㄣˇ
刺激劑	ㄘˋ ㄐㄧ ㄐㄧˋ
刻肌刻骨	ㄎㄜˋ ㄐㄧ ㄎㄜˋ ㄍㄨˇ
剛剛是	ㄍㄤ ㄍㄤ ㄕˋ
割草機	ㄍㄜ ㄘㄠˇ ㄐㄧ
創世紀	ㄔㄨㄤˋ ㄕˋ ㄐㄧˋ
創作技巧	ㄔㄨㄤˋ ㄗㄨㄛˋ ㄐㄧˋ ㄑㄧㄠˇ
創造出	ㄔㄨㄤˋ ㄗㄠˋ ㄔㄨ
努起嘴	ㄋㄨˇ ㄑㄧˇ ㄗㄨㄟˇ
勿忘我	ㄨˋ ㄨㄤˋ ㄨㄛˇ
勿忘草	ㄨˋ ㄨㄤˋ ㄘㄠˇ
匡時濟世	ㄎㄨㄤ ㄕˊ ㄐㄧˋ ㄕˋ
十一個	ㄕˊ ㄧ ㄍㄜˋ
十七個	ㄕˊ ㄑㄧ ㄍㄜˋ
十世紀	ㄕˊ ㄕˋ ㄐㄧˋ
十五個	ㄕˊ ㄨˇ ㄍㄜˋ
十位數	ㄕˊ ㄨㄟˋ ㄕㄨˋ
十堂課	ㄕˊ ㄊㄤˊ ㄎㄜˋ
十姊妹	ㄕˊ ㄗˇ ㄇㄟˋ
十字鎬	ㄕˊ ㄗˋ ㄍㄠˇ
十幾個	ㄕˊ ㄐㄧˇ ㄍㄜˋ
十幾次	ㄕˊ ㄐㄧˇ ㄘˋ
十美圖	ㄕˊ ㄇㄟˇ ㄊㄨˊ
十進位	ㄕˊ ㄐㄧㄣˋ ㄨㄟˋ
印字機	ㄧㄣˋ ㄗˋ ㄐㄧ
危急存亡	ㄨㄟˊ ㄐㄧˊ ㄘㄨㄣˊ ㄨˊ
即使是	ㄐㄧˊ ㄕˇ ㄕˋ
即刻起	ㄐㄧˊ ㄎㄜˋ ㄑㄧˇ
叔祖母	ㄕㄨˊ ㄗㄨˇ ㄇㄨˇ
古文字	ㄍㄨˇ ㄨㄣˊ ㄗˋ
古文體	ㄍㄨˇ ㄨㄣˊ ㄊㄧˇ
古書屋	ㄍㄨˇ ㄕㄨ ㄨ
古神廟	ㄍㄨˇ ㄕㄣˊ ㄇㄧㄠˋ
古體文	ㄍㄨˇ ㄊㄧˇ ㄨㄣˊ
古體詩	ㄍㄨˇ ㄊㄧˇ ㄕ
可以說	ㄎㄜˇ ㄧˇ ㄕㄨㄛ
可以說是	ㄎㄜˇ ㄧˇ ㄕㄨㄛ ㄕˋ
可可樹	ㄎㄜˇ ㄎㄜˇ ㄕㄨˋ
可是要	ㄎㄜˇ ㄕˋ ㄧㄠˋ
可歌可泣	ㄎㄜˇ ㄍㄜ ㄎㄜˇ ㄑㄧˋ
可說是	ㄎㄜˇ ㄕㄨㄛ ㄕˋ
可進可退	ㄎㄜˇ ㄐㄧㄣˋ ㄎㄜˇ ㄊㄨㄟˋ
吃藥時	ㄔ ㄧㄠˋ ㄕˊ
吃錯藥	ㄔ ㄘㄨㄛˋ ㄧㄠˋ
各個擊破	ㄍㄜˋ ㄍㄜ˙ ㄐㄧˊ ㄆㄛˋ
各創一格	ㄍㄜˋ ㄔㄨㄤˋ ㄧ ㄍㄜˊ
各創一格	ㄍㄜˋ ㄔㄨㄤˋ ㄧˋ ㄍㄜˊ
各式各樣	ㄍㄜˋ ㄕˋ ㄍㄜˋ ㄧㄤˋ
各車次	ㄍㄜˋ ㄔㄜ ㄘˋ
吉普車	ㄐㄧˊ ㄆㄨˇ ㄔㄜ
吐吐氣	ㄊㄨˇ ㄊㄨˇ ㄑㄧˋ
吐苦水	ㄊㄨˇ ㄎㄨˇ ㄕㄨㄟˇ
吞吞吐吐	ㄊㄨㄣ ㄊㄨㄣ ㄊㄨˇ ㄊㄨˇ
吵吵鬧鬧	ㄔㄠˇ ㄔㄠˇ ㄋㄠˋ ㄋㄠˋ
吹哨子	ㄔㄨㄟ ㄕㄠˋ ㄗ˙
咪咪叫	ㄇㄧ ㄇㄧ ㄐㄧㄠˋ
咬文嚼字	ㄧㄠˇ ㄨㄣˊ ㄐㄧㄠˊ ㄗˋ
咯咯叫	ㄍㄜ ㄍㄜ ㄐㄧㄠˋ
咯咯叫	ㄍㄜˊ ㄍㄜˊ ㄐㄧㄠˋ
咿咿唔唔	ㄧ ㄧ ㄨˊ ㄨˊ
品格高尚	ㄆㄧㄣˇ ㄍㄜˊ ㄍㄠ ㄕㄤˋ
哭哭啼啼	ㄎㄨ ㄎㄨ ㄊㄧˊ ㄊㄧˊ
唐紹儀	ㄊㄤˊ ㄕㄠˋ ㄧˊ
唐繼堯	ㄊㄤˊ ㄐㄧˋ ㄧㄠˊ
唐高祖	ㄊㄤˊ ㄍㄠ ㄗㄨˇ
唧唧咕咕	ㄐㄧ ㄐㄧ ㄍㄨ ㄍㄨ
唯你是問	ㄨㄟˊ ㄋㄧˇ ㄕˋ ㄨㄣˋ
唯唯諾諾	ㄨㄟˊ ㄨㄟˊ ㄋㄨㄛˋ ㄋㄨㄛˋ
商務艙	ㄕㄤ ㄨˋ ㄘㄤ
商品資金	ㄕㄤ ㄆㄧㄣˇ ㄗ ㄐㄧㄣ
商品輸出	ㄕㄤ ㄆㄧㄣˇ ㄕㄨ ㄔㄨ
商圖國事	ㄕㄤ ㄊㄨˊ ㄍㄨㄛˊ ㄕˋ
問個問題	ㄨㄣˋ ㄍㄜˋ ㄨㄣˋ ㄊㄧˊ
問題是	ㄨㄣˋ ㄊㄧˊ ㄕˋ
啼啼哭哭	ㄊㄧˊ ㄊㄧˊ ㄎㄨ ㄎㄨ
喀土穆	ㄎㄜˋ ㄊㄨˇ ㄇㄨˋ
喔喔叫	ㄛ ㄛ ㄐㄧㄠˋ
喔喔叫	ㄨㄛˋ ㄨㄛˋ ㄐㄧㄠˋ
嘰嘰咕咕	ㄐㄧ ㄐㄧ ㄍㄨ ㄍㄨ
嘴上無毛	ㄗㄨㄟˇ ㄕㄤˋ ㄨˊ ㄇㄠˊ
噗噗跳	ㄆㄨ ㄆㄨ ㄊㄧㄠˋ
噴嘴式	ㄆㄣ ㄗㄨㄟˇ ㄕˋ
噴噴水	ㄆㄣ ㄆㄣ ㄕㄨㄟˇ
噴墨式	ㄆㄣ ㄇㄛˋ ㄕˋ
噴射器	ㄆㄣ ㄕㄜˋ ㄑㄧˋ
噴射客機	ㄆㄣ ㄕㄜˋ ㄎㄜˋ ㄐㄧ
噴射式	ㄆㄣ ㄕㄜˋ ㄕˋ
噴射機	ㄆㄣ ㄕㄜˋ ㄐㄧ
噴氣式	ㄆㄣ ㄑㄧˋ ㄕˋ
噴氣機	ㄆㄣ ㄑㄧˋ ㄐㄧ
噴水池	ㄆㄣ ㄕㄨㄟˇ ㄔˊ
噴霧器	ㄆㄣ ㄨˋ ㄑㄧˋ
噴霧式	ㄆㄣ ㄨˋ ㄕˋ
嚌嚌嘈嘈	ㄐㄧˋ ㄐㄧˋ ㄘㄠˊ ㄘㄠˊ
嚼舌根	ㄐㄧㄠˊ ㄕㄜˊ ㄍㄣ
嚼舌自盡	ㄐㄧㄠˊ ㄕㄜˊ ㄗˋ ㄐㄧㄣˋ
因此是	ㄧㄣ ㄘˇ ㄕˋ
因為是	ㄧㄣ ㄨㄟˋ ㄕˋ
國一上	ㄍㄨㄛˊ ㄧ ㄕㄤˋ
國內市場	ㄍㄨㄛˊ ㄋㄟˋ ㄕˋ ㄔㄤˊ
國內貿易	ㄍㄨㄛˊ ㄋㄟˋ ㄇㄠˋ ㄧˋ
國務秘書	ㄍㄨㄛˊ ㄨˋ ㄇㄧˋ ㄕㄨ
國文科	ㄍㄨㄛˊ ㄨㄣˊ ㄎㄜ
國文課	ㄍㄨㄛˊ ㄨㄣˊ ㄎㄜˋ
國旗歌	ㄍㄨㄛˊ ㄑㄧˊ ㄍㄜ
國策顧問	ㄍㄨㄛˊ ㄘㄜˋ ㄍㄨˋ ㄨㄣˋ
國術社	ㄍㄨㄛˊ ㄕㄨˋ ㄕㄜˋ
國貿科	ㄍㄨㄛˊ ㄇㄠˋ ㄎㄜ
國際市場	ㄍㄨㄛˊ ㄐㄧˋ ㄕˋ ㄔㄤˊ
國際文教	ㄍㄨㄛˊ ㄐㄧˋ ㄨㄣˊ ㄐㄧㄠˋ
國際機場	ㄍㄨㄛˊ ㄐㄧˋ ㄐㄧ ㄔㄤˊ
國際歌	ㄍㄨㄛˊ ㄐㄧˋ ㄍㄜ
國際貿易	ㄍㄨㄛˊ ㄐㄧˋ ㄇㄠˋ ㄧˋ
圖們江	ㄊㄨˊ ㄇㄣˊ ㄐㄧㄤ
圖書史	ㄊㄨˊ ㄕㄨ ㄕˇ
圖書室	ㄊㄨˊ ㄕㄨ ㄕˋ
土味十足	ㄊㄨˇ ㄨㄟˋ ㄕˊ ㄗㄨˊ
土土氣氣	ㄊㄨˇ ㄊㄨˇ ㄑㄧˋ ㄑㄧˋ
土谷祠	ㄊㄨˇ ㄍㄨˇ ㄘˊ
土雞場	ㄊㄨˇ ㄐㄧ ㄔㄤˇ
培養出	ㄆㄟˊ ㄧㄤˇ ㄔㄨ
培養基	ㄆㄟˊ ㄧㄤˇ ㄐㄧ
培養液	ㄆㄟˊ ㄧㄤˇ ㄧˋ
培養皿	ㄆㄟˊ ㄧㄤˇ ㄇㄧㄣˇ
基因體	ㄐㄧ ㄧㄣ ㄊㄧˇ
基礎課	ㄐㄧ ㄔㄨˇ ㄎㄜˋ
基網格	ㄐㄧ ㄨㄤˇ ㄍㄜˊ
堂哥哥	ㄊㄤˊ ㄍㄜ ㄍㄜ
堂哥哥	ㄊㄤˊ ㄍㄜ ㄍㄜ˙
墨沈沈	ㄇㄛˋ ㄔㄣˊ ㄔㄣˊ
士敏土	ㄕˋ ㄇㄧㄣˇ ㄊㄨˇ
奇異果	ㄑㄧˊ ㄧˋ ㄍㄨㄛˇ
奇蹟式	ㄑㄧˊ ㄐㄧ ㄕˋ
套問出	ㄊㄠˋ ㄨㄣˋ ㄔㄨ
奢侈品	ㄕㄜ ㄔˇ ㄆㄧㄣˇ
奧氏體	ㄠˋ ㄕˋ ㄊㄧˇ
奧義書	ㄠˋ ㄧˋ ㄕㄨ
妳自己	ㄋㄧˇ ㄗˋ ㄐㄧˇ
姊妹品	ㄗˇ ㄇㄟˋ ㄆㄧㄣˇ
姊妹市	ㄗˇ ㄇㄟˋ ㄕˋ
始祖鳥	ㄕˇ ㄗㄨˇ ㄋㄧㄠˇ
委託金	ㄨㄟˇ ㄊㄨㄛ ㄐㄧㄣ
威士忌	ㄨㄟ ㄕˋ ㄐㄧˋ
娘娘腔	ㄋㄧㄤˊ ㄋㄧㄤˊ ㄑㄧㄤ
媒體問題	ㄇㄟˊ ㄊㄧˇ ㄨㄣˋ ㄊㄧˊ
嬌嬌嫩嫩	ㄐㄧㄠ ㄐㄧㄠ ㄋㄣˋ ㄋㄣˋ
子午儀	ㄗˇ ㄨˇ ㄧˊ
子囊殼	ㄗˇ ㄋㄤˊ ㄎㄜˊ
字幕機	ㄗˋ ㄇㄨˋ ㄐㄧ
存儲器	ㄘㄨㄣˊ ㄔㄨˊ ㄑㄧˋ
孤孤淒淒	ㄍㄨ ㄍㄨ ㄑㄧ ㄑㄧ
宜古宜今	ㄧˊ ㄍㄨˇ ㄧˊ ㄐㄧㄣ
室內設計	ㄕˋ ㄋㄟˋ ㄕㄜˋ ㄐㄧˋ
寄存器	ㄐㄧˋ ㄘㄨㄣˊ ㄑㄧˋ
寄存處	ㄐㄧˋ ㄘㄨㄣˊ ㄔㄨˋ
寄物處	ㄐㄧˋ ㄨˋ ㄔㄨˋ
密跡金剛	ㄇㄧˋ ㄐㄧ ㄐㄧㄣ ㄍㄤ
密集式	ㄇㄧˋ ㄐㄧˊ ㄕˋ
密集金剛	ㄇㄧˋ ㄐㄧˊ ㄐㄧㄣ ㄍㄤ
實物交易	ㄕˊ ㄨˋ ㄐㄧㄠ ㄧˋ
實際上	ㄕˊ ㄐㄧˋ ㄕㄤˋ
實際氣體	ㄕˊ ㄐㄧˋ ㄑㄧˋ ㄊㄧˇ
實體詞	ㄕˊ ㄊㄧˇ ㄘˊ
審計處	ㄕㄣˇ ㄐㄧˋ ㄔㄨˇ
寸土寸金	ㄘㄨㄣˋ ㄊㄨˇ ㄘㄨㄣˋ ㄐㄧㄣ
射擊場	ㄕㄜˋ ㄐㄧˊ ㄔㄤˇ
將可以	ㄐㄧㄤ ㄎㄜˇ ㄧˇ
將盡未盡	ㄐㄧㄤ ㄐㄧㄣˋ ㄨㄟˋ ㄐㄧㄣˋ
少數民族	ㄕㄠˇ ㄕㄨˋ ㄇㄧㄣˊ ㄗㄨˊ
少根筋	ㄕㄠˇ ㄍㄣ ㄐㄧㄣ
尼特族	ㄋㄧˊ ㄊㄜˋ ㄗㄨˊ
尿失禁	ㄋㄧㄠˋ ㄕ ㄐㄧㄣˋ
岌岌可危	ㄐㄧˊ ㄐㄧˊ ㄎㄜˇ ㄨㄟˊ
左上角	ㄗㄨㄛˇ ㄕㄤˋ ㄐㄧㄠˇ
己飢己溺	ㄐㄧˇ ㄐㄧ ㄐㄧˇ ㄋㄧˋ
市場上	ㄕˋ ㄔㄤˊ ㄕㄤˋ
帷幕牆	ㄨㄟˊ ㄇㄨˋ ㄑㄧㄤˊ
常規武器	ㄔㄤˊ ㄍㄨㄟ ㄨˇ ㄑㄧˋ
幾世紀	ㄐㄧˇ ㄕˋ ㄐㄧˋ
幾位數	ㄐㄧˇ ㄨㄟˋ ㄕㄨˋ
幾十個	ㄐㄧˇ ㄕˊ ㄍㄜ˙
幾梯次	ㄐㄧˇ ㄊㄧ ㄘˋ
座上客	ㄗㄨㄛˋ ㄕㄤˋ ㄎㄜˋ
庫存股票	ㄎㄨˋ ㄘㄨㄣˊ ㄍㄨˇ ㄆㄧㄠˋ
庫藏股	ㄎㄨˋ ㄘㄤˊ ㄍㄨˇ
庶務組	ㄕㄨˋ ㄨˋ ㄗㄨˇ
庶幾無愧	ㄕㄨˋ ㄐㄧˇ ㄨˊ ㄎㄨㄟˋ
康康舞	ㄎㄤ ㄎㄤ ㄨˇ
廣告社	ㄍㄨㄤˇ ㄍㄠˋ ㄕㄜˋ
引以為傲	ㄧㄣˇ ㄧˇ ㄨㄟˊ ㄠˋ
引以為恥	ㄧㄣˇ ㄧˇ ㄨㄟˊ ㄔˇ
引伸出	ㄧㄣˇ ㄕㄣ ㄔㄨ
引申作	ㄧㄣˇ ㄕㄣ ㄗㄨㄛˋ
往往是	ㄨㄤˇ ㄨㄤˇ ㄕˋ
忙忙急急	ㄇㄤˊ ㄇㄤˊ ㄐㄧˊ ㄐㄧˊ
怎麼樣	ㄗㄜˇ ㄇㄛ˙ ㄧㄤˋ
怎麼說	ㄗㄜˇ ㄇㄛ˙ ㄕㄨㄛ
急急忙忙	ㄐㄧˊ ㄐㄧˊ ㄇㄤˊ ㄇㄤˊ
恣意妄為	ㄗˋ ㄧˋ ㄨㄤˋ ㄨㄟˊ
悶燒鍋	ㄇㄣ ㄕㄠ ㄍㄨㄛ
悶燒鍋	ㄇㄣˋ ㄕㄠ ㄍㄨㄛ
惡衣惡食	ㄨˋ ㄧ ㄨˋ ㄕˊ
意味深長	ㄧˋ ㄨㄟˋ ㄕㄣ ㄔㄤˊ
意氣揚揚	ㄧˋ ㄑㄧˋ ㄧㄤˊ ㄧㄤˊ
意氣昂揚	ㄧˋ ㄑㄧˋ ㄤˊ ㄧㄤˊ
慰問金	ㄨㄟˋ ㄨㄣˋ ㄐㄧㄣ
我哥哥	ㄨㄛˇ ㄍㄜ ㄍㄜ
我自己	ㄨㄛˇ ㄗˋ ㄐㄧˇ
戚繼光	ㄑㄧ ㄐㄧˋ ㄍㄨㄤ
抑抑揚格	ㄧˋ ㄧˋ ㄧㄤˊ ㄍㄜˊ
抗議書	ㄎㄤˋ ㄧˋ ㄕㄨ
拋射體	ㄆㄠ ㄕㄜˋ ㄊㄧˇ
拼字母	ㄆㄧㄣ ㄗˋ ㄇㄨˇ
拼音字母	ㄆㄧㄣ ㄧㄣ ㄗˋ ㄇㄨˇ
拼音文字	ㄆㄧㄣ ㄧㄣ ㄨㄣˊ ㄗˋ
挪威文	ㄋㄨㄛˊ ㄨㄟ ㄨㄣˊ
捨己為國	ㄕㄜˇ ㄐㄧˇ ㄨㄟˋ ㄍㄨㄛˊ
捨我其誰	ㄕㄜˇ ㄨㄛˇ ㄑㄧˊ ㄕㄟˊ
推土機	ㄊㄨㄟ ㄊㄨˇ ㄐㄧ
推進器	ㄊㄨㄟ ㄐㄧㄣˋ ㄑㄧˋ
推進機	ㄊㄨㄟ ㄐㄧㄣˋ ㄐㄧ
描一描	ㄇㄧㄠˊ ㄧ ㄇㄧㄠˊ
描一描	ㄇㄧㄠˊ ㄧˋ ㄇㄧㄠˊ
提提神	ㄊㄧˊ ㄊㄧˊ ㄕㄣˊ
揚子江	ㄧㄤˊ ㄗˇ ㄐㄧㄤ
揚子津	ㄧㄤˊ ㄗˇ ㄐㄧㄣ
揚眉吐氣	ㄧㄤˊ ㄇㄟˊ ㄊㄨˇ ㄑㄧˋ
搖唇鼓舌	ㄧㄠˊ ㄔㄨㄣˊ ㄍㄨˇ ㄕㄜˊ
搖脣鼓舌	ㄧㄠˊ ㄔㄨㄣˊ ㄍㄨˇ ㄕㄜˊ
搞什麼	ㄍㄠˇ ㄕㄜˊ ㄇㄛˊ
摩托車	ㄇㄛˊ ㄊㄨㄛ ㄔㄜ
摩拖車	ㄇㄛˊ ㄊㄨㄛ ㄔㄜ
摩門教	ㄇㄛˊ ㄇㄣˊ ㄐㄧㄠˋ
摩門教徒	ㄇㄛˊ ㄇㄣˊ ㄐㄧㄠˋ ㄊㄨˊ
摸咪咪	ㄇㄛ ㄇㄧ ㄇㄧ
操場上	ㄘㄠ ㄔㄤˇ ㄕㄤˋ
擒賊擒王	ㄑㄧㄣˊ ㄗㄟˊ ㄑㄧㄣˊ ㄨㄤˊ
擴音器	ㄎㄨㄛˋ ㄧㄣ ㄑㄧˋ
擴音機	ㄎㄨㄛˋ ㄧㄣ ㄐㄧ
故事書	ㄍㄨˋ ㄕˋ ㄕㄨ
故作神祕	ㄍㄨˋ ㄗㄨㄛˋ ㄕㄣˊ ㄇㄧˋ
故作神秘	ㄍㄨˋ ㄗㄨㄛˋ ㄕㄣˊ ㄇㄧˋ
教務組	ㄐㄧㄠˋ ㄨˋ ㄗㄨˇ
教務處	ㄐㄧㄠˋ ㄨˋ ㄔㄨˋ
教書匠	ㄐㄧㄠ ㄕㄨ ㄐㄧㄤˋ
教科文	ㄐㄧㄠˋ ㄎㄜ ㄨㄣˊ
教科書	ㄐㄧㄠˋ ㄎㄜ ㄕㄨ
敲一敲	ㄑㄧㄠ ㄧˋ ㄑㄧㄠ
數位器	ㄕㄨˋ ㄨㄟˋ ㄑㄧˋ
數目字	ㄕㄨˋ ㄇㄨˋ ㄗˋ
數矛字	ㄕㄨˋ ㄇㄠˊ ㄗˋ
文字交	ㄨㄣˊ ㄗˋ ㄐㄧㄠ
文字幕	ㄨㄣˊ ㄗˋ ㄇㄨˋ
文教處	ㄨㄣˊ ㄐㄧㄠˋ ㄔㄨˋ
文武場	ㄨㄣˊ ㄨˇ ㄔㄤˇ
文武廟	ㄨㄣˊ ㄨˇ ㄇㄧㄠˋ
文物組	ㄨㄣˊ ㄨˋ ㄗㄨˇ
文革時期	ㄨㄣˊ ㄍㄜˊ ㄕˊ ㄑㄧˊ
斤斤計較	ㄐㄧㄣ ㄐㄧㄣ ㄐㄧˋ ㄐㄧㄠˋ
施密特	ㄕ ㄇㄧˋ ㄊㄜˋ
施氏食獅史	ㄕ ㄕˋ ㄕˊ ㄕ ㄕˇ
旁敲側擊	ㄆㄤˊ ㄑㄧㄠ ㄘㄜˋ ㄐㄧˊ
早晨時	ㄗㄠˇ ㄔㄣˊ ㄕˊ
早睡早起	ㄗㄠˇ ㄕㄨㄟˋ ㄗㄠˇ ㄑㄧˇ
昂貴品	ㄤˊ ㄍㄨㄟˋ ㄆㄧㄣˇ
時時刻刻	ㄕˊ ㄕˊ ㄎㄜˋ ㄎㄜˋ
時計商	ㄕˊ ㄐㄧˋ ㄕㄤ
晉江市	ㄐㄧㄣˋ ㄐㄧㄤ ㄕˋ
普考及格	ㄆㄨˇ ㄎㄠˇ ㄐㄧˊ ㄍㄜˊ
暮氣沉沉	ㄇㄨˋ ㄑㄧˋ ㄔㄣˊ ㄔㄣˊ
暮氧沉沉	ㄇㄨˋ ㄧㄤˇ ㄔㄣˊ ㄔㄣˊ
曝光計	ㄆㄨˋ ㄍㄨㄤ ㄐㄧˋ
曝氣槽	ㄆㄨˋ ㄑㄧˋ ㄘㄠˊ
曠古未聞	ㄎㄨㄤˋ ㄍㄨˇ ㄨㄟˋ ㄨㄣˊ
曠課時數	ㄎㄨㄤˋ ㄎㄜˋ ㄕˊ ㄕㄨˋ
曳引機	ㄧˋ ㄧㄣˇ ㄐㄧ
最可以	ㄗㄨㄟˋ ㄎㄜˇ ㄧˇ
最糟糕	ㄗㄨㄟˋ ㄗㄠ ㄍㄠ
最高國務	ㄗㄨㄟˋ ㄍㄠ ㄍㄨㄛˊ ㄨˋ
最高氣溫	ㄗㄨㄟˋ ㄍㄠ ㄑㄧˋ ㄨㄣ
最高溫	ㄗㄨㄟˋ ㄍㄠ ㄨㄣ
最高潮	ㄗㄨㄟˋ ㄍㄠ ㄔㄠˊ
最高級	ㄗㄨㄟˋ ㄍㄠ ㄐㄧˊ
望你早歸	ㄨㄤˋ ㄋㄧˇ ㄗㄠˇ ㄍㄨㄟ
望塵莫及	ㄨㄤˋ ㄔㄣˊ ㄇㄛˋ ㄐㄧˊ
期末考	ㄑㄧˊ ㄇㄛˋ ㄎㄠˇ
木刻術	ㄇㄨˋ ㄎㄜ ㄕㄨˋ
木刻術	ㄇㄨˋ ㄎㄜˋ ㄕㄨˋ
未盡事宜	ㄨㄟˋ ㄐㄧㄣˋ ㄕˋ ㄧˊ
果子醬	ㄍㄨㄛˇ ㄗ˙ ㄐㄧㄤˋ
枯水位	ㄎㄨ ㄕㄨㄟˇ ㄨㄟˋ
枯水期	ㄎㄨ ㄕㄨㄟˇ ㄑㄧˊ
枯燥無味	ㄎㄨ ㄗㄠˋ ㄨˊ ㄨㄟˋ
格子窗	ㄍㄜˊ ㄗ˙ ㄔㄨㄤ
梧棲港	ㄨˊ ㄑㄧ ㄍㄤˇ
樞密使	ㄕㄨ ㄇㄧˋ ㄕˇ
模擬器	ㄇㄛˊ ㄋㄧˇ ㄑㄧˋ
模擬考	ㄇㄛˊ ㄋㄧˇ ㄎㄠˇ
模造品	ㄇㄛˊ ㄗㄠˋ ㄆㄧㄣˇ
樣品屋	ㄧㄤˋ ㄆㄧㄣˇ ㄨ
機器字	ㄐㄧ ㄑㄧˋ ㄗˋ
機要祕書	ㄐㄧ ㄧㄠˋ ㄇㄧˋ ㄕㄨ
機車處	ㄐㄧ ㄔㄜ ㄔㄨˋ
次常式	ㄘˋ ㄔㄤˊ ㄕˋ
次級品	ㄘˋ ㄐㄧˊ ㄆㄧㄣˇ
歌舞伎	ㄍㄜ ㄨˇ ㄐㄧˋ
此一時	ㄘˇ ㄧ ㄕˊ
此時此刻	ㄘˇ ㄕˊ ㄘˇ ㄎㄜˋ
武昌起義	ㄨˇ ㄔㄤ ㄑㄧˇ ㄧˋ
武藝高強	ㄨˇ ㄧˋ ㄍㄠ ㄑㄧㄤˊ
歧音異義字	ㄑㄧˊ ㄧㄣ ㄧˋ ㄧˋ ㄗˋ
殃及無辜	ㄧㄤ ㄐㄧˊ ㄨˊ ㄍㄨ
母以子貴	ㄇㄨˇ ㄧˇ ㄗˇ ㄍㄨㄟˋ
每一個	ㄇㄟˇ ㄧ ㄍㄜ˙
每一個	ㄇㄟˇ ㄧˊ ㄍㄜ˙
毛毛糙糙	ㄇㄠˊ ㄇㄠˊ ㄘㄠ ㄘㄠ
毛毛躁躁	ㄇㄠˊ ㄇㄠˊ ㄗㄠˋ ㄗㄠˋ
毛皮衣	ㄇㄠˊ ㄆㄧˊ ㄧ
毛茛科	ㄇㄠˊ ㄍㄣˋ ㄎㄜ
民意基礎	ㄇㄧㄣˊ ㄧˋ ㄐㄧ ㄔㄨˇ
民族史	ㄇㄧㄣˊ ㄗㄨˊ ㄕˇ
民族問題	ㄇㄧㄣˊ ㄗㄨˊ ㄨㄣˋ ㄊㄧˊ
民族意識	ㄇㄧㄣˊ ㄗㄨˊ ㄧˋ ㄕˋ
民為貴	ㄇㄧㄣˊ ㄨㄟˊ ㄍㄨㄟˋ
氣數已盡	ㄑㄧˋ ㄕㄨˋ ㄧˇ ㄐㄧㄣˋ
氣昂昂	ㄑㄧˋ ㄤˊ ㄤˊ
氣溫計	ㄑㄧˋ ㄨㄣ ㄐㄧˋ
水位圖	ㄕㄨㄟˇ ㄨㄟˋ ㄊㄨˊ
水位計	ㄕㄨㄟˇ ㄨㄟˋ ㄐㄧˋ
水果糖	ㄕㄨㄟˇ ㄍㄨㄛˇ ㄊㄤˊ
水楊樹	ㄕㄨㄟˇ ㄧㄤˊ ㄕㄨˋ
水汪汪	ㄕㄨㄟˇ ㄨㄤ ㄨㄤ
水泥廠	ㄕㄨㄟˇ ㄋㄧˊ ㄔㄤˇ
水泥漆	ㄕㄨㄟˇ ㄋㄧˊ ㄑㄧ
水泥漿	ㄕㄨㄟˇ ㄋㄧˊ ㄐㄧㄤ
水泥石	ㄕㄨㄟˇ ㄋㄧˊ ㄕˊ
水煤氣	ㄕㄨㄟˇ ㄇㄟˊ ㄑㄧˋ
水磨石	ㄕㄨㄟˇ ㄇㄛˊ ㄕˊ
水舀子	ㄕㄨㄟˇ ㄧㄠˇ ㄗ˙
水蛇腰	ㄕㄨㄟˇ ㄕㄜˊ ㄧㄠ
水蜜桃	ㄕㄨㄟˇ ㄇㄧˋ ㄊㄠˊ
水銀槽	ㄕㄨㄟˇ ㄧㄣˊ ㄘㄠˊ
水銀計	ㄕㄨㄟˇ ㄧㄣˊ ㄐㄧˋ
污水槽	ㄨ ㄕㄨㄟˇ ㄘㄠˊ
汲水機	ㄐㄧˊ ㄕㄨㄟˇ ㄐㄧ
沈積石	ㄔㄣˊ ㄐㄧ ㄕˊ
沉積物	ㄔㄣˊ ㄐㄧ ㄨˋ
沉默是金	ㄔㄣˊ ㄇㄛˋ ㄕˋ ㄐㄧㄣ
沒什麼	ㄇㄟˊ ㄕㄜˊ ㄇㄛ˙
沒怎樣	ㄇㄟˊ ㄗㄜˇ ㄧㄤˋ
沒怎麼	ㄇㄟˊ ㄗㄜˇ ㄇㄛ˙
沒沒無聞	ㄇㄛˋ ㄇㄛˋ ㄨˊ ㄨㄣˊ
沒親沒故	ㄇㄟˊ ㄑㄧㄣ ㄇㄟˊ ㄍㄨˋ
沒說出	ㄇㄟˊ ㄕㄨㄛ ㄔㄨ
沒骨氣	ㄇㄟˊ ㄍㄨˇ ㄑㄧˋ
泌尿器	ㄇㄧˋ ㄋㄧㄠˋ ㄑㄧˋ
泌尿科	ㄇㄧˋ ㄋㄧㄠˋ ㄎㄜ
泡泡糖	ㄆㄠˋ ㄆㄠˋ ㄊㄤˊ
泣鬼神	ㄑㄧˋ ㄍㄨㄟˇ ㄕㄣˊ
泥土牆	ㄋㄧˊ ㄊㄨˇ ㄑㄧㄤˊ
泥水匠	ㄋㄧˊ ㄕㄨㄟˇ ㄐㄧㄤˋ
泥水師	ㄋㄧˊ ㄕㄨㄟˇ ㄕ
泥盆紀	ㄋㄧˊ ㄆㄣˊ ㄐㄧˋ
洋文書	ㄧㄤˊ ㄨㄣˊ ㄕㄨ
洋槍洋砲	ㄧㄤˊ ㄑㄧㄤ ㄧㄤˊ ㄆㄠˋ
洋氣十足	ㄧㄤˊ ㄑㄧˋ ㄕˊ ㄗㄨˊ
洋鬼子	ㄧㄤˊ ㄍㄨㄟˇ ㄗ˙
涉世未深	ㄕㄜˋ ㄕˋ ㄨㄟˋ ㄕㄣ
淘氣鬼	ㄊㄠˊ ㄑㄧˋ ㄍㄨㄟˇ
深水港	ㄕㄣ ㄕㄨㄟˇ ㄍㄤˇ
測位器	ㄘㄜˋ ㄨㄟˋ ㄑㄧˋ
測微計	ㄘㄜˋ ㄨㄟˊ ㄐㄧˋ
測溫器	ㄘㄜˋ ㄨㄣ ㄑㄧˋ
測試儀	ㄘㄜˋ ㄕˋ ㄧˊ
測音器	ㄘㄜˋ ㄧㄣ ㄑㄧˋ
測高計	ㄘㄜˋ ㄍㄠ ㄐㄧˋ
渺渺茫茫	ㄇㄧㄠˇ ㄇㄧㄠˇ ㄇㄤˊ ㄇㄤˊ
渺茫無望	ㄇㄧㄠˇ ㄇㄤˊ ㄨˊ ㄨㄤˋ
滋養品	ㄗ ㄧㄤˇ ㄆㄧㄣˇ
滲出物	ㄕㄣˋ ㄔㄨ ㄨˋ
激光器	ㄐㄧ ㄍㄨㄤ ㄑㄧˋ
瀋陽市	ㄕㄣˇ ㄧㄤˊ ㄕˋ
炒作股票	ㄔㄠˇ ㄗㄨㄛˋ ㄍㄨˇ ㄆㄧㄠˋ
炒股票	ㄔㄠˇ ㄍㄨˇ ㄆㄧㄠˋ
為什麼	ㄨㄟˋ ㄕㄜˊ ㄇㄜ˙
為你們	ㄨㄟˋ ㄋㄧˇ ㄇㄣ˙
為我們	ㄨㄟˋ ㄨㄛˇ ㄇㄣ˙
為數甚微	ㄨㄟˊ ㄕㄨˋ ㄕㄣˋ ㄨㄟˊ
為時過早	ㄨㄟˊ ㄕˊ ㄍㄨㄛˋ ㄗㄠˇ
為甚麼	ㄨㄟˋ ㄕㄜˊ ㄇㄜ˙
烏沈沈	ㄨ ㄔㄣˊ ㄔㄣˊ
烏骨雞	ㄨ ㄍㄨˇ ㄐㄧ
無事忙	ㄨˊ ㄕˋ ㄇㄤˊ
無以為繼	ㄨˊ ㄧˇ ㄨㄟˊ ㄐㄧˋ
無依無靠	ㄨˊ ㄧ ㄨˊ ㄎㄠˋ
無國籍	ㄨˊ ㄍㄨㄛˊ ㄐㄧˊ
無意義	ㄨˊ ㄧˋ ㄧˋ
無意識	ㄨˊ ㄧˋ ㄕˋ
無技可施	ㄨˊ ㄐㄧˋ ㄎㄜˇ ㄕ
無時無刻	ㄨˊ ㄕˊ ㄨˊ ㄎㄜˋ
無果果樹	ㄨˊ ㄍㄨㄛˇ ㄍㄨㄛˇ ㄕㄨˋ
無根水	ㄨˊ ㄍㄣ ㄕㄨㄟˇ
無機物	ㄨˊ ㄐㄧ ㄨˋ
無機體	ㄨˊ ㄐㄧ ㄊㄧˇ
無畏施	ㄨˊ ㄨㄟˋ ㄕ
無異是	ㄨˊ ㄧˋ ㄕˋ
無異議	ㄨˊ ㄧˋ ㄧˋ
無疑是	ㄨˊ ㄧˊ ㄕˋ
無盡期	ㄨˊ ㄐㄧㄣˋ ㄑㄧˊ
無窗式	ㄨˊ ㄔㄨㄤ ㄕˋ
無翼鳥	ㄨˊ ㄧˋ ㄋㄧㄠˇ
無處可逃	ㄨˊ ㄔㄨˋ ㄎㄜˇ ㄊㄠˊ
無計可施	ㄨˊ ㄐㄧˋ ㄎㄜˇ ㄕ
無霜期	ㄨˊ ㄕㄨㄤ ㄑㄧˊ
無題詩	ㄨˊ ㄊㄧˊ ㄕ
熬藥湯	ㄠˊ ㄧㄠˋ ㄊㄤ
燒燒水	ㄕㄠ ㄕㄠ ㄕㄨㄟˇ
燒石膏	ㄕㄠ ㄕˊ ㄍㄠ
燜燒鍋	ㄇㄣ ㄕㄠ ㄍㄨㄛ
燜燒鍋	ㄇㄣˋ ㄕㄠ ㄍㄨㄛ
牡羊座	ㄇㄨˇ ㄧㄤˊ ㄗㄨㄛˋ
特技師	ㄊㄜˋ ㄐㄧˋ ㄕ
特教組	ㄊㄜˋ ㄐㄧㄠˋ ㄗㄨˇ
特級上將	ㄊㄜˋ ㄐㄧˊ ㄕㄤˋ ㄐㄧㄤˋ
特級品	ㄊㄜˋ ㄐㄧˊ ㄆㄧㄣˇ
獅子座	ㄕ ㄗˇ ㄗㄨㄛˋ
獅子舞	ㄕ ㄗ˙ ㄨˇ
王國維	ㄨㄤˊ ㄍㄨㄛˊ ㄨㄟˊ
王室貴族	ㄨㄤˊ ㄕˋ ㄍㄨㄟˋ ㄗㄨˊ
王母娘娘	ㄨㄤˊ ㄇㄨˇ ㄋㄧㄤˊ ㄋㄧㄤˊ
王親貴族	ㄨㄤˊ ㄑㄧㄣ ㄍㄨㄟˋ ㄗㄨˊ
瑤池金母	ㄧㄠˊ ㄔˊ ㄐㄧㄣ ㄇㄨˇ
異教徒	ㄧˋ ㄐㄧㄠˋ ㄊㄨˊ
異體字	ㄧˋ ㄊㄧˇ ㄗˋ
疏疏密密	ㄕㄨ ㄕㄨ ㄇㄧˋ ㄇㄧˋ
疑問詞	ㄧˊ ㄨㄣˋ ㄘˊ
疑神疑鬼	ㄧˊ ㄕㄣˊ ㄧˊ ㄍㄨㄟˇ
皮條客	ㄆㄧˊ ㄊㄧㄠˊ ㄎㄜˋ
皮毛衣	ㄆㄧˊ ㄇㄠˊ ㄧ
皮革商	ㄆㄧˊ ㄍㄜˊ ㄕㄤ
盡義務	ㄐㄧㄣˋ ㄧˋ ㄨˋ
睡一覺	ㄕㄨㄟˋ ㄧ ㄐㄧㄠˋ
睡一覺	ㄕㄨㄟˋ ㄧˊ ㄐㄧㄠˋ
睡午覺	ㄕㄨㄟˋ ㄨˇ ㄐㄧㄠˋ
睡睡覺	ㄕㄨㄟˋ ㄕㄨㄟˋ ㄐㄧㄠˋ
睡覺時	ㄕㄨㄟˋ ㄐㄧㄠˋ ㄕˊ
瞄一瞄	ㄇㄧㄠˊ ㄧˋ ㄇㄧㄠˊ
瞧一瞧	ㄑㄧㄠˊ ㄧ ㄑㄧㄠˊ
石室金匱	ㄕˊ ㄕˋ ㄐㄧㄣ ㄍㄨㄟˋ
石獅子	ㄕˊ ㄕ ㄗ˙
石門水庫	ㄕˊ ㄇㄣˊ ㄕㄨㄟˇ ㄎㄨˋ
石鼓文	ㄕˊ ㄍㄨˇ ㄨㄣˊ
破音字	ㄆㄛˋ ㄧㄣ ㄗˋ
破體字	ㄆㄛˋ ㄊㄧˇ ㄗˋ
碩果僅存	ㄕㄨㄛˋ ㄍㄨㄛˇ ㄐㄧㄣˇ ㄘㄨㄣˊ
磨光機	ㄇㄛˊ ㄍㄨㄤ ㄐㄧ
磨石子	ㄇㄛˊ ㄕˊ ㄗˇ
示威抗議	ㄕˋ ㄨㄟ ㄎㄤˋ ㄧˋ
示意圖	ㄕˋ ㄧˋ ㄊㄨˊ
社教組	ㄕㄜˋ ㄐㄧㄠˋ ㄗㄨˇ
祕書處	ㄇㄧˋ ㄕㄨ ㄔㄨˋ
祖師廟	ㄗㄨˇ ㄕ ㄇㄧㄠˋ
神出鬼沒	ㄕㄣˊ ㄔㄨ ㄍㄨㄟˇ ㄇㄛˋ
神氣十足	ㄕㄣˊ ㄑㄧˋ ㄕˊ ㄗㄨˊ
科威特	ㄎㄜ ㄨㄟ ㄊㄜˋ
科技史	ㄎㄜ ㄐㄧˋ ㄕˇ
科技股	ㄎㄜ ㄐㄧˋ ㄍㄨˇ
科教組	ㄎㄜ ㄐㄧㄠˋ ㄗㄨˇ
秘書室	ㄇㄧˋ ㄕㄨ ㄕˋ
秘書處	ㄇㄧˋ ㄕㄨ ㄔㄨˋ
稅務處	ㄕㄨㄟˋ ㄨˋ ㄔㄨˋ
穩穩固固	ㄨㄣˇ ㄨㄣˇ ㄍㄨˋ ㄍㄨˋ
窩囊氣	ㄨㄛ ㄋㄤˊ ㄑㄧˋ
米格機	ㄇㄧˇ ㄍㄜˊ ㄐㄧ
粗毛羊	ㄘㄨ ㄇㄠˊ ㄧㄤˊ
糯米糕	ㄋㄨㄛˋ ㄇㄧˇ ㄍㄠ
純粹是	ㄔㄨㄣˊ ㄘㄨㄟˋ ㄕˋ
紫葡萄	ㄗˇ ㄆㄨˊ ㄊㄠˊ
紫藥水	ㄗˇ ㄧㄠˋ ㄕㄨㄟˇ
組譯器	ㄗㄨˇ ㄧˋ ㄑㄧˋ
給水器	ㄍㄟˇ ㄕㄨㄟˇ ㄑㄧˋ
緊急啟事	ㄐㄧㄣˇ ㄐㄧˊ ㄑㄧˇ ㄕˋ
緊急措施	ㄐㄧㄣˇ ㄐㄧˊ ㄘㄨㄛˋ ㄕ
緊身衣	ㄐㄧㄣˇ ㄕㄣ ㄧ
緊身褲	ㄐㄧㄣˇ ㄕㄣ ㄎㄨˋ
羊毛皮	ㄧㄤˊ ㄇㄠˊ ㄆㄧˊ
羊毛衣	ㄧㄤˊ ㄇㄠˊ ㄧ
羊皮襖	ㄧㄤˊ ㄆㄧˊ ㄠˇ
羊角虱	ㄧㄤˊ ㄐㄧㄠˇ ㄕ
美則美矣	ㄇㄟˇ ㄗㄜˊ ㄇㄟˇ ㄧˇ
美國式	ㄇㄟˇ ㄍㄨㄛˊ ㄕˋ
美術史	ㄇㄟˇ ㄕㄨˋ ㄕˇ
美術品	ㄇㄟˇ ㄕㄨˋ ㄆㄧㄣˇ
美術商	ㄇㄟˇ ㄕㄨˋ ㄕㄤ
美術字	ㄇㄟˇ ㄕㄨˋ ㄗˋ
美術課	ㄇㄟˇ ㄕㄨˋ ㄎㄜˋ
羔羊皮	ㄍㄠ ㄧㄤˊ ㄆㄧˊ
義務役	ㄧˋ ㄨˋ ㄧˋ
翹舌音	ㄑㄧㄠˋ ㄕㄜˊ ㄧㄣ
耀武揚威	ㄧㄠˋ ㄨˇ ㄧㄤˊ ㄨㄟ
考古題	ㄎㄠˇ ㄍㄨˇ ㄊㄧˊ
考考試	ㄎㄠˇ ㄎㄠˇ ㄕˋ
考試及格	ㄎㄠˇ ㄕˋ ㄐㄧˊ ㄍㄜˊ
考試時	ㄎㄠˇ ㄕˋ ㄕˊ
聘姑娘	ㄆㄧㄣˋ ㄍㄨ ㄋㄧㄤˊ
聞雞起舞	ㄨㄣˊ ㄐㄧ ㄑㄧˇ ㄨˇ
股票市場	ㄍㄨˇ ㄆㄧㄠˋ ㄕˋ ㄔㄤˊ
股票族	ㄍㄨˇ ㄆㄧㄠˋ ㄗㄨˊ
胃潰瘍	ㄨㄟˋ ㄎㄨㄟˋ ㄧㄤˊ
胃腸科	ㄨㄟˋ ㄔㄤˊ ㄎㄜ
脫毛劑	ㄊㄨㄛ ㄇㄠˊ ㄐㄧˋ
脫水機	ㄊㄨㄛ ㄕㄨㄟˇ ㄐㄧ
脫衣舞	ㄊㄨㄛ ㄧ ㄨˇ
脫衣舞孃	ㄊㄨㄛ ㄧ ㄨˇ ㄋㄧㄤˊ
腎臟科	ㄕㄣˋ ㄗㄤˋ ㄎㄜ
腦勺子	ㄋㄠˇ ㄕㄠˊ ㄗ˙
腦垂體	ㄋㄠˇ ㄔㄨㄟˊ ㄊㄧˇ
腦殼子	ㄋㄠˇ ㄎㄜˊ ㄗ˙
腰金拖紫	ㄧㄠ ㄐㄧㄣ ㄊㄨㄛ ㄗˇ
腰金衣紫	ㄧㄠ ㄐㄧㄣ ㄧ ㄗˇ
腰金衣紫	ㄧㄠ ㄐㄧㄣ ㄧˋ ㄗˇ
臥鋪票	ㄨㄛˋ ㄆㄨˋ ㄆㄧㄠˋ
自以為是	ㄗˋ ㄧˇ ㄨㄟˊ ㄕˋ
自噴式	ㄗˋ ㄆㄣ ㄕˋ
自我作古	ㄗˋ ㄨㄛˇ ㄗㄨㄛˋ ㄍㄨˇ
自我陶醉	ㄗˋ ㄨㄛˇ ㄊㄠˊ ㄗㄨㄟˋ
自此刻起	ㄗˋ ㄘˇ ㄎㄜˋ ㄑㄧˇ
自此時起	ㄗˋ ㄘˇ ㄕˊ ㄑㄧˇ
自給自足	ㄗˋ ㄐㄧˇ ㄗˋ ㄗㄨˊ
自視甚高	ㄗˋ ㄕˋ ㄕㄣˋ ㄍㄠ
自討苦吃	ㄗˋ ㄊㄠˇ ㄎㄨˇ ㄔ
自調式	ㄗˋ ㄊㄧㄠˊ ㄕˋ
自足自給	ㄗˋ ㄗㄨˊ ㄗˋ ㄐㄧˇ
自食其果	ㄗˋ ㄕˊ ㄑㄧˊ ㄍㄨㄛˇ
自食惡果	ㄗˋ ㄕˊ ㄜˋ ㄍㄨㄛˇ
舌根音	ㄕㄜˊ ㄍㄣ ㄧㄣ
舍我其誰	ㄕㄜˇ ㄨㄛˇ ㄑㄧˊ ㄕㄟˊ
舍我其誰	ㄕㄜˇ ㄨㄛˇ ㄑㄧˊ ㄕㄨㄟˊ
芒果樹	ㄇㄤˊ ㄍㄨㄛˇ ㄕㄨˋ
芒果皮	ㄇㄤˊ ㄍㄨㄛˇ ㄆㄧˊ
茅草屋	ㄇㄠˊ ㄘㄠˇ ㄨ
草莓族	ㄘㄠˇ ㄇㄟˊ ㄗㄨˊ
草莓醬	ㄘㄠˇ ㄇㄟˊ ㄐㄧㄤˋ
莫測高深	ㄇㄛˋ ㄘㄜˋ ㄍㄠ ㄕㄣ
菩提子	ㄆㄨˊ ㄊㄧˊ ㄗˇ
菩提樹	ㄆㄨˊ ㄊㄧˊ ㄕㄨˋ
葡萄樹	ㄆㄨˊ ㄊㄠˊ ㄕㄨˋ
葡萄糖	ㄆㄨˊ ㄊㄠˊ ㄊㄤˊ
葦眉子	ㄨㄟˇ ㄇㄟˊ ㄗˇ
葬儀社	ㄗㄤˋ ㄧˊ ㄕㄜˋ
蔣渭水	ㄐㄧㄤˇ ㄨㄟˋ ㄕㄨㄟˇ
蔣緯國	ㄐㄧㄤˇ ㄨㄟˇ ㄍㄨㄛˊ
藏匿處	ㄘㄤˊ ㄋㄧˋ ㄔㄨˋ
藏書室	ㄘㄤˊ ㄕㄨ ㄕˋ
藏書庫	ㄘㄤˊ ㄕㄨ ㄎㄨˋ
藝術史	ㄧˋ ㄕㄨˋ ㄕˇ
藝術品	ㄧˋ ㄕㄨˋ ㄆㄧㄣˇ
藝術美	ㄧˋ ㄕㄨˋ ㄇㄟˇ
藥劑師	ㄧㄠˋ ㄐㄧˋ ㄕ
藥引子	ㄧㄠˋ ㄧㄣˇ ㄗ˙
蛇鼠一窩	ㄕㄜˊ ㄕㄨˇ ㄧˋ ㄨㄛ
蝕刻師	ㄕˊ ㄎㄜ ㄕ
衣紫腰金	ㄧ ㄗˇ ㄧㄠ ㄐㄧㄣ
衣紫腰金	ㄧˋ ㄗˇ ㄧㄠ ㄐㄧㄣ
衣紫腰銀	ㄧ ㄗˇ ㄧㄠ ㄧㄣˊ
衣紫腰銀	ㄧˋ ㄗˇ ㄧㄠ ㄧㄣˊ
襯托出	ㄔㄣˋ ㄊㄨㄛ ㄔㄨ
襯托物	ㄔㄣˋ ㄊㄨㄛ ㄨˋ
視為一體	ㄕˋ ㄨㄟˊ ㄧ ㄊㄧˇ
視為一體	ㄕˋ ㄨㄟˊ ㄧˋ ㄊㄧˇ
視網膜	ㄕˋ ㄨㄤˇ ㄇㄛˋ
親姊妹	ㄑㄧㄣ ㄗˇ ㄇㄟˋ
觸摸式	ㄔㄨˋ ㄇㄛ ㄕˋ
計數器	ㄐㄧˋ ㄕㄨˋ ㄑㄧˋ
計時器	ㄐㄧˋ ㄕˊ ㄑㄧˋ
記事文	ㄐㄧˋ ㄕˋ ㄨㄣˊ
記事體	ㄐㄧˋ ㄕˋ ㄊㄧˇ
記憶體	ㄐㄧˋ ㄧˋ ㄊㄧˇ
記述文	ㄐㄧˋ ㄕㄨˋ ㄨㄣˊ
記述體	ㄐㄧˋ ㄕㄨˋ ㄊㄧˇ
設計圖	ㄕㄜˋ ㄐㄧˋ ㄊㄨˊ
設計師	ㄕㄜˋ ㄐㄧˋ ㄕ
試一試	ㄕˋ ㄧ ㄕˋ
試車場	ㄕˋ ㄔㄜ ㄔㄤˇ
試金石	ㄕˋ ㄐㄧㄣ ㄕˊ
試音室	ㄕˋ ㄧㄣ ㄕˋ
詩文集	ㄕ ㄨㄣˊ ㄐㄧˊ
誣告罪	ㄨˊ ㄍㄠˋ ㄗㄨㄟˋ
誤以為	ㄨˋ ㄧˇ ㄨㄟˊ
說一是一	ㄕㄨㄛ ㄧ ㄕˋ ㄧ
說一說	ㄕㄨㄛ ㄧ ㄕㄨㄛ
說一說	ㄕㄨㄛ ㄧˋ ㄕㄨㄛ
說教術	ㄕㄨㄛ ㄐㄧㄠˋ ㄕㄨˋ
說破嘴	ㄕㄨㄛ ㄆㄛˋ ㄗㄨㄟˇ
說說唱唱	ㄕㄨㄛ ㄕㄨㄛ ㄔㄤˋ ㄔㄤˋ
調劑品	ㄊㄧㄠˊ ㄐㄧˋ ㄆㄧㄣˇ
調味品	ㄊㄧㄠˊ ㄨㄟˋ ㄆㄧㄣˇ
調皮鬼	ㄊㄧㄠˊ ㄆㄧˊ ㄍㄨㄟˇ
調配出	ㄊㄧㄠˊ ㄆㄟˋ ㄔㄨ
調音師	ㄊㄧㄠˊ ㄧㄣ ㄕ
講故事	ㄐㄧㄤˇ ㄍㄨˋ ㄕˋ
講武堂	ㄐㄧㄤˇ ㄨˇ ㄊㄤˊ
識時務	ㄕˋ ㄕˊ ㄨˋ
議事規則	ㄧˋ ㄕˋ ㄍㄨㄟ ㄗㄜˊ
貓王迷	ㄇㄠ ㄨㄤˊ ㄇㄧˊ
貧民窟	ㄆㄧㄣˊ ㄇㄧㄣˊ ㄎㄨ
貴金屬	ㄍㄨㄟˋ ㄐㄧㄣ ㄕㄨˇ
貴陽市	ㄍㄨㄟˋ ㄧㄤˊ ㄕˋ
貿易商	ㄇㄠˋ ㄧˋ ㄕㄤ
貿易額	ㄇㄠˋ ㄧˋ ㄜˊ
資格考試	ㄗ ㄍㄜˊ ㄎㄠˇ ㄕˋ
賠償物	ㄆㄟˊ ㄔㄤˊ ㄨˋ
赤條條	ㄔˋ ㄊㄧㄠˊ ㄊㄧㄠˊ
起初是	ㄑㄧˇ ㄔㄨ ㄕˋ
起坐室	ㄑㄧˇ ㄗㄨㄛˋ ㄕˋ
起居室	ㄑㄧˇ ㄐㄧ ㄕˋ
起水泡	ㄑㄧˇ ㄕㄨㄟˇ ㄆㄠˋ
起跑器	ㄑㄧˇ ㄆㄠˇ ㄑㄧˋ
超級市場	ㄔㄠ ㄐㄧˊ ㄕˋ ㄔㄤˊ
超級強國	ㄔㄠ ㄐㄧˊ ㄑㄧㄤˊ ㄍㄨㄛˊ
超高溫	ㄔㄠ ㄍㄠ ㄨㄣ
超高頻	ㄔㄠ ㄍㄠ ㄆㄧㄣˊ
足衣足食	ㄗㄨˊ ㄧ ㄗㄨˊ ㄕˊ
跑跑跳跳	ㄆㄠˇ ㄆㄠˇ ㄊㄧㄠˋ ㄊㄧㄠˋ
跳舞場	ㄊㄧㄠˋ ㄨˇ ㄔㄤˇ
蹉跎光陰	ㄘㄨㄛ ㄊㄨㄛˊ ㄍㄨㄤ ㄧㄣ
蹉跎時光	ㄘㄨㄛ ㄊㄨㄛˊ ㄕˊ ㄍㄨㄤ
身體上	ㄕㄣ ㄊㄧˇ ㄕㄤˋ
身高計	ㄕㄣ ㄍㄠ ㄐㄧˋ
輸出品	ㄕㄨ ㄔㄨ ㄆㄧㄣˇ
輸出阻抗	ㄕㄨ ㄔㄨ ㄗㄨˇ ㄎㄤˋ
迄今已	ㄑㄧˋ ㄐㄧㄣ ㄧˇ
近廟欺神	ㄐㄧㄣˋ ㄇㄧㄠˋ ㄑㄧ ㄕㄣˊ
近期內	ㄐㄧㄣˋ ㄑㄧˊ ㄋㄟˋ
近體詩	ㄐㄧㄣˋ ㄊㄧˇ ㄕ
迫擊炮	ㄆㄛˋ ㄐㄧˊ ㄆㄠˋ
迫擊砲	ㄆㄛˋ ㄐㄧˊ ㄆㄠˋ
述異記	ㄕㄨˋ ㄧˋ ㄐㄧˋ
迷你車	ㄇㄧˊ ㄋㄧˇ ㄔㄜ
迷迷茫茫	ㄇㄧˊ ㄇㄧˊ ㄇㄤˊ ㄇㄤˊ
退場式	ㄊㄨㄟˋ ㄔㄤˇ ㄕˋ
退燒藥	ㄊㄨㄟˋ ㄕㄠ ㄧㄠˋ
退除役	ㄊㄨㄟˋ ㄔㄨˊ ㄧˋ
逃脫出	ㄊㄠˊ ㄊㄨㄛ ㄔㄨ
逛一逛	ㄍㄨㄤˋ ㄧˊ ㄍㄨㄤˋ
進退維谷	ㄐㄧㄣˋ ㄊㄨㄟˋ ㄨㄟˊ ㄍㄨˇ
進進出出	ㄐㄧㄣˋ ㄐㄧㄣˋ ㄔㄨ ㄔㄨ
過往甚密	ㄍㄨㄛˋ ㄨㄤˇ ㄕㄣˋ ㄇㄧˋ
過甚其詞	ㄍㄨㄛˋ ㄕㄣˋ ㄑㄧˊ ㄘˊ
過過癮	ㄍㄨㄛˋ ㄍㄨㄛˋ ㄧㄣˇ
違抗上級	ㄨㄟˊ ㄎㄤˋ ㄕㄤˋ ㄐㄧˊ
違禁品	ㄨㄟˊ ㄐㄧㄣˋ ㄆㄧㄣˇ
遙測計	ㄧㄠˊ ㄘㄜˋ ㄐㄧˋ
遙遙無期	ㄧㄠˊ ㄧㄠˊ ㄨˊ ㄑㄧˊ
遲早是	ㄔˊ ㄗㄠˇ ㄕˋ
遺失啟事	ㄧˊ ㄕ ㄑㄧˇ ㄕˋ
郭子儀	ㄍㄨㄛ ㄗˇ ㄧˊ
配子體	ㄆㄟˋ ㄗˇ ㄊㄧˇ
配給品	ㄆㄟˋ ㄐㄧˇ ㄆㄧㄣˇ
配給票	ㄆㄟˋ ㄐㄧˇ ㄆㄧㄠˋ
配藥師	ㄆㄟˋ ㄧㄠˋ ㄕ
酢漿草	ㄗㄨㄛˋ ㄐㄧㄤ ㄘㄠˇ
酢醬草	ㄗㄨㄛˋ ㄐㄧㄤˋ ㄘㄠˇ
醫務室	ㄧ ㄨˋ ㄕˋ
醫藥品	ㄧ ㄧㄠˋ ㄆㄧㄣˇ
醬缸氣	ㄐㄧㄤˋ ㄍㄤ ㄑㄧˋ
釀造品	ㄋㄧㄤˋ ㄗㄠˋ ㄆㄧㄣˇ
金剛怒目	ㄐㄧㄣ ㄍㄤ ㄋㄨˋ ㄇㄨˋ
金剛杵	ㄐㄧㄣ ㄍㄤ ㄔㄨˇ
金剛石	ㄐㄧㄣ ㄍㄤ ㄕˊ
金創藥	ㄐㄧㄣ ㄔㄨㄤˋ ㄧㄠˋ
金匱石室	ㄐㄧㄣ ㄍㄨㄟˋ ㄕˊ ㄕˋ
金屋藏嬌	ㄐㄧㄣ ㄨ ㄘㄤˊ ㄐㄧㄠ
金屬光澤	ㄐㄧㄣ ㄕㄨˇ ㄍㄨㄤ ㄗㄜˊ
金屬器皿	ㄐㄧㄣ ㄕㄨˇ ㄑㄧˋ ㄇㄧㄣˇ
金屬模	ㄐㄧㄣ ㄕㄨˇ ㄇㄛˊ
金屬礦床	ㄐㄧㄣ ㄕㄨˇ ㄎㄨㄤˋ ㄔㄨㄤˊ
金屬膜	ㄐㄧㄣ ㄕㄨˇ ㄇㄛˊ
金屬銻	ㄐㄧㄣ ㄕㄨˇ ㄊㄧˋ
金屬陶瓷	ㄐㄧㄣ ㄕㄨˇ ㄊㄠˊ ㄘˊ
金瘡藥	ㄐㄧㄣ ㄔㄨㄤ ㄧㄠˋ
金石交	ㄐㄧㄣ ㄕˊ ㄐㄧㄠ
金石堂	ㄐㄧㄣ ㄕˊ ㄊㄤˊ
金石文	ㄐㄧㄣ ㄕˊ ㄨㄣˊ
金石文字記	ㄐㄧㄣ ㄕˊ ㄨㄣˊ ㄗˋ ㄐㄧˋ
金龜子	ㄐㄧㄣ ㄍㄨㄟ ㄗ˙
金龜車	ㄐㄧㄣ ㄍㄨㄟ ㄔㄜ
銀根緊	ㄧㄣˊ ㄍㄣ ㄐㄧㄣˇ
鋼筋水泥	ㄍㄤ ㄐㄧㄣ ㄕㄨㄟˇ ㄋㄧˊ
錦囊妙計	ㄐㄧㄣˇ ㄋㄤˊ ㄇㄧㄠˋ ㄐㄧˋ
錦衣衛	ㄐㄧㄣˇ ㄧ ㄨㄟˋ
長崎市	ㄔㄤˊ ㄑㄧˊ ㄕˋ
長春市	ㄔㄤˊ ㄔㄨㄣ ㄕˋ
長條圖	ㄔㄤˊ ㄊㄧㄠˊ ㄊㄨˊ
長此以往	ㄔㄤˊ ㄘˇ ㄧˇ ㄨㄤˇ
闖進闖出	ㄔㄨㄤˇ ㄐㄧㄣˋ ㄔㄨㄤˇ ㄔㄨ
阻抗匹配	ㄗㄨˇ ㄎㄤˋ ㄆㄧ ㄆㄟˋ
除塵器	ㄔㄨˊ ㄔㄣˊ ㄑㄧˋ
除惡務盡	ㄔㄨˊ ㄜˋ ㄨˋ ㄐㄧㄣˋ
除溼機	ㄔㄨˊ ㄕ ㄐㄧ
除濕機	ㄔㄨˊ ㄕ ㄐㄧ
除草劑	ㄔㄨˊ ㄘㄠˇ ㄐㄧˋ
除草機	ㄔㄨˊ ㄘㄠˇ ㄐㄧ
除霜機	ㄔㄨˊ ㄕㄨㄤ ㄐㄧ
陰氣沉沉	ㄧㄣ ㄑㄧˋ ㄔㄣˊ ㄔㄣˊ
陰沈沈	ㄧㄣ ㄔㄣˊ ㄔㄣˊ
陰沉沉	ㄧㄣ ㄔㄣˊ ㄔㄣˊ
陰陰沈沈	ㄧㄣ ㄧㄣ ㄔㄣˊ ㄔㄣˊ
陰陰沉沉	ㄧㄣ ㄧㄣ ㄔㄣˊ ㄔㄣˊ
陳其美	ㄔㄣˊ ㄑㄧˊ ㄇㄟˇ
陳子昂	ㄔㄣˊ ㄗˇ ㄤˊ
陳皮梅	ㄔㄣˊ ㄆㄧˊ ㄇㄟˊ
陳義甚高	ㄔㄣˊ ㄧˋ ㄕㄣˋ ㄍㄠ
陶瓷器	ㄊㄠˊ ㄘˊ ㄑㄧˋ
陶藝品	ㄊㄠˊ ㄧˋ ㄆㄧㄣˇ
陽剛味	ㄧㄤˊ ㄍㄤ ㄨㄟˋ
陽剛氣	ㄧㄤˊ ㄍㄤ ㄑㄧˋ
陽極泥	ㄧㄤˊ ㄐㄧˊ ㄋㄧˊ
隔音牆	ㄍㄜˊ ㄧㄣ ㄑㄧㄤˊ
隱藏式	ㄧㄣˇ ㄘㄤˊ ㄕˋ
隱身術	ㄧㄣˇ ㄕㄣ ㄕㄨˋ
隱隱藏藏	ㄧㄣˇ ㄧㄣˇ ㄘㄤˊ ㄘㄤˊ
集錦式	ㄐㄧˊ ㄐㄧㄣˇ ㄕˋ
集體創作	ㄐㄧˊ ㄊㄧˇ ㄔㄨㄤˋ ㄗㄨㄛˋ
雙子座	ㄕㄨㄤ ㄗˇ ㄗㄨㄛˋ
雙槓體操	ㄕㄨㄤ ㄍㄤˋ ㄊㄧˇ ㄘㄠ
雙氧水	ㄕㄨㄤ ㄧㄤˇ ㄕㄨㄟˇ
雞兔問題	ㄐㄧ ㄊㄨˋ ㄨㄣˋ ㄊㄧˊ
雞屁股	ㄐㄧ ㄆㄧˋ ㄍㄨˇ
靠水吃水	ㄎㄠˋ ㄕㄨㄟˇ ㄔ ㄕㄨㄟˇ
靠牆角	ㄎㄠˋ ㄑㄧㄤˊ ㄐㄧㄠˇ
靠自己	ㄎㄠˋ ㄗˋ ㄐㄧˇ
韋眉子	ㄨㄟˊ ㄇㄟˊ ㄗ˙
食品商	ㄕˊ ㄆㄧㄣˇ ㄕㄤ
食品廠	ㄕˊ ㄆㄧㄣˇ ㄔㄤˇ
食品舖	ㄕˊ ㄆㄧㄣˇ ㄆㄨˋ
飲水機	ㄧㄣˇ ㄕㄨㄟˇ ㄐㄧ
飲醇自醉	ㄧㄣˇ ㄔㄨㄣˊ ㄗˋ ㄗㄨㄟˋ
飲食無味	ㄧㄣˇ ㄕˊ ㄨˊ ㄨㄟˋ
餃子皮	ㄐㄧㄠˇ ㄗ˙ ㄆㄧˊ
養雞場	ㄧㄤˇ ㄐㄧ ㄔㄤˇ
驕奢淫佚	ㄐㄧㄠ ㄕㄜ ㄧㄣˊ ㄧˋ
驕奢淫逸	ㄐㄧㄠ ㄕㄜ ㄧㄣˊ ㄧˋ
骨骼肌	ㄍㄨˇ ㄍㄜˊ ㄐㄧ
骯骯髒髒	ㄤ ㄤ ㄗㄤ ㄗㄤ
骯髒鬼	ㄤ ㄗㄤ ㄍㄨㄟˇ
體溫計	ㄊㄧˇ ㄨㄣ ㄐㄧˋ
高一上	ㄍㄠ ㄧ ㄕㄤˋ
高個子	ㄍㄠ ㄍㄜˋ ㄗ˙
高射炮	ㄍㄠ ㄕㄜˋ ㄆㄠˋ
高射砲	ㄍㄠ ㄕㄜˋ ㄆㄠˋ
高帽子	ㄍㄠ ㄇㄠˋ ㄗ˙
高普考	ㄍㄠ ㄆㄨˇ ㄎㄠˇ
高深莫測	ㄍㄠ ㄕㄣ ㄇㄛˋ ㄘㄜˋ
高溫計	ㄍㄠ ㄨㄣ ㄐㄧˋ
高潮時	ㄍㄠ ㄔㄠˊ ㄕˊ
高祖母	ㄍㄠ ㄗㄨˇ ㄇㄨˇ
高科技	ㄍㄠ ㄎㄜ ㄐㄧˋ
高級品	ㄍㄠ ㄐㄧˊ ㄆㄧㄣˇ
高級社	ㄍㄠ ㄐㄧˊ ㄕㄜˋ
高考及格	ㄍㄠ ㄎㄠˇ ㄐㄧˊ ㄍㄜˊ
鬧意氣	ㄋㄠˋ ㄧˋ ㄑㄧˋ
鬧脾氣	ㄋㄠˋ ㄆㄧˊ ㄑㄧˋ
鬼故事	ㄍㄨㄟˇ ㄍㄨˋ ㄕˋ
魔術師	ㄇㄛˊ ㄕㄨˋ ㄕ
魔高一尺	ㄇㄛˊ ㄍㄠ ㄧˋ ㄔˇ
鳥為食亡	ㄋㄧㄠˇ ㄨㄟˊ ㄕˊ ㄨㄤˊ
鳥窩式	ㄋㄧㄠˇ ㄨㄛ ㄕˋ
默默無聞	ㄇㄛˋ ㄇㄛˋ ㄨˊ ㄨㄣˊ
鼓舌搖脣	ㄍㄨˇ ㄕㄜˊ ㄧㄠˊ ㄔㄨㄣˊ
鼓舞士氣	ㄍㄨˇ ㄨˇ ㄕˋ ㄑㄧˋ
鼓鼓囊囊	ㄍㄨˇ ㄍㄨˇ ㄋㄤˊ ㄋㄤˊ
鼠尾草	ㄕㄨˇ ㄨㄟˇ ㄘㄠˇ
齊眉棍	ㄑㄧˊ ㄇㄟˊ ㄍㄨㄣˋ
龐克族	ㄆㄤˊ ㄎㄜˋ ㄗㄨˊ
