# LANG=en
a 		[冠詞] 一個;一種
a few 		[片語] 一些
a little 		[片語] 一點點
a lot 		[片語] 很多
A.M. 		[縮寫] 上午
able 		[形容詞] 能;有能力的
about 		[介系詞] 大約;關於
above 		[介系詞] 在…之上
abroad 		[副詞] 在國外
across 		[介系詞] 橫越;穿過
act 		[動詞] 扮演; [名詞] 行動,法案
action 		[名詞] 動作
actor 		[名詞] 男演員
actress 		[名詞] 女演員
afraid 		[形容詞] 害怕
after 		[介系詞] 在…之後; [連接詞] 在...之後
afternoon 		[名詞] 下午;午後
again 		[副詞] 再一次
age 		[名詞] 年齡
ago 		[副詞] 以前
agree 		[動詞] 同意
ahead 		[副詞] 在前;向前;預先;事前
air 		[名詞] 空氣
airplane 		[名詞] 飛機
airport 		[名詞] 飛機場
all 		[形容詞] 所有的;全部; [代名詞] 一切
almost 		[副詞] 幾乎
along 		[介系詞] 沿著
already 		[副詞] 已經
also 		[副詞] 也
although 		[連接詞] 雖然
always 		[副詞] 總是
am 		[動詞] 是,在; be 動詞第一人稱,單數,現在式
America 		[名詞] 美國;美洲
American 		[形容詞] 美國的;美洲的; [名詞] 美國人
an 		[冠詞] 一個;一種
and 		[連接詞] 和
angry 		[形容詞] 生氣的
animal 		[名詞] 動物
another 		[形容詞] 另一個; [代名詞] 另一個
answer 		[動詞] 回答; [名詞] 答案
ant 		[名詞] 螞蟻
any 		[形容詞] 任何的; [代名詞] 任何一個
anybody 		[代名詞] 任何人
anyone 		[代名詞] 任何人
anything 		[代名詞] 任何事物
apartment 		[名詞] 公寓
appear 		[動詞] 出現
apple 		[名詞] 蘋果
April 		[名詞] 四月
are 		[動詞] 是,在; be 動詞第一、第三人稱, 複數, 現在式; 第二次人單、複數, 現在式
aren't 		[縮短形] are not
arm 		[名詞] 手臂
around 		[介系詞] 差不多;環繞
arrive 		[動詞] 到達
art 		[名詞] 藝術
as 		[介系詞] 當作;和…一樣; [連接詞] 依照;當...時
ask 		[動詞] 問
at 		[介系詞] 在
attack 		[動詞] 進攻;襲擊; [名詞] 攻擊
August 		[名詞] 八月
aunt 		[名詞] 姨媽;姑媽
autumn 		[名詞] 秋季
away 		[形容詞] 不在的; [副詞] 離開
baby 		[名詞] 嬰兒
back 		[副詞] 回原處; [名詞] 背部;後面
bad 		[形容詞] 壞的
badminton 		[名詞] 羽毛球
bag 		[名詞] 袋子
bake 		[動詞] 烘;烤
bakery 		[名詞] 麵包店
balcony 		[名詞] 陽臺
ball 		[名詞] 球
banana 		[名詞] 香蕉
band 		[名詞] 樂團;樂隊
bank 		[名詞] 銀行;堤;岸
barbecue 		[名詞] 烤肉
base 		[名詞] 基;底;基部
baseball 		[名詞] 棒球
basket 		[名詞] 籃子
basketball 		[名詞] 籃球
bat 		[名詞] 球棒;蝙蝠
bath 		[名詞] 洗澡
bathroom 		[名詞] 廁所;浴室
be 		[動詞] 是;要;有;在; [助動詞] 正在...,被…
beach 		[名詞] 海灘
bean 		[名詞] 豆莢;豆子
bear 		[動詞] 承受; [名詞] 熊
beautiful 		[形容詞] 漂亮的
because 		[連接詞] 因為
become 		[動詞] 變成
bed 		[名詞] 床
bedroom 		[名詞] 臥房
bee 		[名詞] 蜜蜂
beef 		[名詞] 牛肉
before 		[介系詞] 在…之前
begin 		[動詞] 開始
behind 		[介系詞] 在…後面
believe 		[動詞] 相信
bell 		[名詞] 鈴;鐘
belong 		[動詞] 屬於
below 		[介系詞] 在…之下
belt 		[名詞] 腰帶
bench 		[名詞] 長凳;長椅
beside 		[介系詞] 在...旁側
between 		[介系詞] 在…和…之間
bicycle 		[名詞] 腳踏車
big 		[形容詞] 大的
bike 		[動詞] 騎腳踏車; [名詞] 腳踏車
bird 		[名詞] 鳥
birthday 		[名詞] 生日
bite 		[動詞] 咬
black 		[形容詞] 黑色的; [名詞] 黑色;美國黑人
blackboard 		[名詞] 黑板
blanket 		[名詞] 毯子
blind 		[形容詞] 瞎的
block 		[動詞] 阻塞; [名詞] 街區
blow 		[動詞] 吹
blue 		[形容詞] 藍色的; [名詞] 藍色
boat 		[名詞] 小船
body 		[名詞] 身體
boil 		[動詞] (水等)沸騰;開;滾
book 		[名詞] 書本
bookstore 		[名詞] 書店
bore 		[動詞] 使厭煩
boring 		[形容詞] 乏味的
born 		[形容詞] 出生的;誕生的
borrow 		[動詞] 借
boss 		[名詞] 老闆
both 		[形容詞] 兩者; [代名詞] 兩者(都)
bottle 		[名詞] 瓶子
bottom 		[名詞] 底部;屁股
bow 		[動詞] 鞠躬; [名詞] 弓
bowl 		[名詞] 碗
box 		[名詞] 箱;盒;匣
boy 		[名詞] 男孩
bread 		[名詞] 麵包
break 		[動詞] 斷裂;中斷; [名詞] 暫停
breakfast 		[名詞] 早餐
bridge 		[名詞] 橋
bright 		[形容詞] 光亮的
bring 		[動詞] 帶來
brother 		[名詞] 兄;弟
brown 		[形容詞] 褐色的;棕色的; [名詞] 棕色
brush 		[動詞] 刷; [名詞] 刷子
bug 		[名詞] 小蟲
build 		[動詞] 建造;蓋
bun 		[名詞] 小圓麵包
burn 		[動詞] 燒;燙傷; [名詞] 灼傷
bus 		[名詞] 公車
business 		[名詞] 商業;事
businessman 		[名詞] 商人
busy 		[形容詞] 忙碌的
but 		[連接詞] 但是
butter 		[名詞] 奶油
butterfly 		[名詞] 蝴蝶
buy 		[動詞] 買
by 		[介系詞] 經由
bye 		[感歎詞] 再見;再會
cage 		[名詞] 鳥籠;獸籠
cake 		[名詞] 蛋糕
call 		[動詞] 喊;打電話
camera 		[名詞] 照相機
camp 		[動詞] 露營; [名詞] 營地
can 		[助動詞] 能; [名詞] 罐頭
candle 		[名詞] 蠟燭
candy 		[名詞] 糖果
cannot 		[助動詞] 不能
can't 		[縮短形] cannot (can 的反義)
cap 		[名詞] 無邊便帽;蓋子
car 		[名詞] 汽車
card 		[名詞] 卡片
care 		[動詞] 關心;照顧
careful 		[形容詞] 小心的
carry 		[動詞] 提;搬運
case 		[名詞] 盒子;案件
castle 		[名詞] 城堡
cat 		[名詞] 貓
catch 		[動詞] 接(球);捕獲
celebrate 		[動詞] 慶祝
cell phone 		[名詞] 手機
cellphone 		[名詞] 手機,大哥大
cent 		[名詞] 分(錢幣)
center 		[名詞] 中心(點)
centimeter 		[名詞] 公分
chair 		[名詞] 椅子
chalk 		[名詞] 粉筆
chance 		[名詞] 機會
change 		[動詞] 改變;更改; [名詞] 零錢
cheap 		[形容詞] 便宜的
cheat 		[動詞] 欺騙;作弊
check 		[動詞] 檢查; [名詞] 支票;買單
cheer 		[動詞] 向...歡呼; [名詞] 喝采;鼓勵
cheese 		[名詞] 起司;乳酪
chess 		[名詞] 西洋棋
chicken 		[名詞] 雞;雞肉
child 		[名詞] 小孩
China 		[名詞] 中國
Chinese 		[形容詞] 中國的;中國人的; [名詞] 中文;中國人
chocolate 		[名詞] 巧克力
choose 		[動詞] 選擇;挑選
chopsticks 		[名詞] 筷子
Christmas 		[名詞] 耶誕節
church 		[名詞] 教堂
circle 		[名詞] 圓圈;集團
city 		[名詞] 都市
clap 		[動詞] 拍(手);鼓(掌)
class 		[名詞] 階級;班級;上課
classmate 		[名詞] 同班同學
classroom 		[名詞] 教室
clean 		[形容詞] 乾淨的; [動詞] 打掃
clear 		[形容詞] 清楚的;晴朗的
clerk 		[名詞] 店員;辦事員;職員
climb 		[動詞] 爬;攀登
clock 		[名詞] 鐘
close 		[形容詞] 近的;密切的; [動詞] 關上
cloudy 		[形容詞] 多雲的;陰天的
club 		[名詞] 俱樂部;夜總會;社團
coat 		[名詞] 外套
coffee 		[名詞] 咖啡
cola 		[名詞] 可樂
cold 		[形容詞] 寒冷的; [名詞] 感冒
collect 		[動詞] 收集
color 		[名詞] 顏色
comb 		[動詞] 用梳子梳理; [名詞] 梳子
come 		[動詞] 到來
comfortable 		[形容詞] 舒適的
comic 		[形容詞] 滑稽的; [名詞] 漫畫
common 		[形容詞] 常見的
computer 		[名詞] 電腦
convenient 		[形容詞] 方便的
cook 		[動詞] 煮; [名詞] 廚師
cookie 		[名詞] 餅乾
cool 		[形容詞] 涼快的;很棒的;酷
copy 		[動詞] 拷貝;抄襲; [名詞] 拷貝;副本
corner 		[名詞] 角落
correct 		[形容詞] 正確的; [動詞] 改正;糾正
cost 		[動詞] 花費; [名詞] 費用;成本
couch 		[名詞] 長沙發
couldn't 		[縮短形] could not
count 		[動詞] 計算;數; [名詞] 計數;計算
country 		[名詞] 國家;鄉下
course 		[名詞] 課程;科目
cousin 		[名詞] 表(堂)兄弟姊妹
cover 		[動詞] 蓋住; [名詞] 封面
cow 		[名詞] 母牛
crazy 		[形容詞] 古怪的;著迷的
cross 		[動詞] 越過;渡過; [名詞] 十字架
cry 		[動詞] 哭叫
cup 		[名詞] 杯子
cut 		[動詞] 切割;剪
cute 		[形容詞] 可愛的
dad 		[名詞] 父親
daddy 		[名詞] 父親
dance 		[動詞] 跳舞; [名詞] 舞會
dangerous 		[形容詞] 危險的
dark 		[形容詞] 黑暗的
date 		[動詞] 約會; [名詞] 日期
daughter 		[名詞] 女兒
day 		[名詞] 白天;日
dead 		[形容詞] 死的
deal 		[動詞] 處理;對付;對待[(+with)]; [名詞] 交易
dear 		[形容詞] 親愛的
December 		[名詞] 十二月
decide 		[動詞] 決定
delicious 		[形容詞] 好吃的
dentist 		[名詞] 牙醫
department store 		[名詞] 百貨公司
desk 		[名詞] 書桌
dictionary 		[名詞] 字典
didn't 		[縮短形] did not
die 		[動詞] 死; [名詞] 骰子
different 		[形容詞] 不同的
difficult 		[形容詞] 困難的
dig 		[動詞] 挖掘
dining room 		[名詞] 飯廳
dinner 		[名詞] 晚餐
dirty 		[形容詞] 骯髒的
dish 		[名詞] 盤子;一盤菜
do 		[動詞] 做; [助動詞] 構成否定句,疑問句,或強調句
doctor 		[名詞] 醫生
dodge ball 		[名詞] 躲避球遊戲
doesn't 		[縮短形] does not
dog 		[名詞] 狗
doll 		[名詞] 洋娃娃
dollar 		[名詞] 美元
don't 		[縮短形] do not
door 		[名詞] 門
dot 		[名詞] 點;小圓點
down 		[介系詞] 向下
dozen 		[名詞] 一打
Dr. 		[縮寫] 醫生
dragon 		[名詞] 龍
draw 		[動詞] 畫;繪製;描寫; [名詞] 平局;平手
drawer 		[名詞] 抽屜
dream 		[名詞] 夢
dress 		[動詞] 穿著; [名詞] 洋裝
drink 		[動詞] 喝; [名詞] 飲料
drive 		[動詞] 開車
driver 		[名詞] 司機
drop 		[動詞] (使)滴落;丟下
drum 		[名詞] 鼓
dry 		[形容詞] 乾的
duck 		[名詞] 鴨
dumpling 		[名詞] 餃子
during 		[介系詞] 在…期間
each 		[形容詞] 每個; [代名詞] 各個
ear 		[名詞] 耳朵
early 		[形容詞] 早的;提早的; [副詞] 早;提早
earth 		[名詞] 地球;土地
east 		[形容詞] 東方的; [副詞] 向東方; [名詞] 東方
Easter 		[名詞] 復活節
easy 		[形容詞] 容易的
eat 		[動詞] 吃
egg 		[名詞] 蛋
eight 		[形容詞] 八的; [名詞] 八
eighteen 		[形容詞] 十八的; [名詞] 十八
eighty 		[形容詞] 八十的; [名詞] 八十
either 		[形容詞] 兩者之一; [副詞] 也; [連接詞] 或者(和or連用)
elementary school 		[名詞] 小學
elephant 		[名詞] 大象
eleven 		[形容詞] 十一的; [名詞] 十一
else 		[形容詞] 其他的
e-mail 		[名詞] 電子郵件
end 		[動詞] 結束; [名詞] 盡頭;結局
engineer 		[名詞] 工程師
English 		[名詞] 英語
enjoy 		[動詞] 喜歡;享受
enough 		[形容詞] 足夠的
enter 		[動詞] 輸入;進入
envelope 		[名詞] 信封
eraser 		[名詞] 橡皮擦
eve 		[名詞] 前夕
even 		[形容詞] 均勻的;偶數的;平手的; [副詞] 即使
ever 		[副詞] 從來;曾經
every 		[形容詞] 每一個的
everybody 		[代名詞] 每個人
everyone 		[代名詞] 每個人
everything 		[代名詞] 每樣事物;重於一切
example 		[名詞] 例子
excellent 		[形容詞] 非常好的
except 		[介系詞] 除…之外
excited 		[形容詞] 感到興奮的
exciting 		[形容詞] 令人興奮的
excuse 		[動詞] 原諒;借光; [名詞] 藉口
exercise 		[名詞] 運動;習題
expensive 		[形容詞] 貴的
experience 		[動詞] 經歷;感受; [名詞] 經驗
eye 		[名詞] 眼睛
face 		[名詞] 臉
fact 		[名詞] 事實
factory 		[名詞] 工廠
fail 		[動詞] 失敗;不及格
fall 		[動詞] 掉下; [名詞] 秋天
family 		[名詞] 家庭
famous 		[形容詞] 著名的
fan 		[名詞] 風扇;扇子;迷友
far 		[形容詞] 遠的
farm 		[動詞] 耕作;養殖;經營農場;從事畜牧業; [名詞] 農場
farmer 		[名詞] 農夫
fast 		[形容詞] 快的
fat 		[形容詞] 胖的
father 		[名詞] 父親
favorite 		[形容詞] 最喜愛的
February 		[名詞] 二月
feed 		[動詞] 吃;餵養
feel 		[動詞] 感覺
festival 		[名詞] 節日
fever 		[名詞] 發燒
few 		[形容詞] 少數的;一些; [代名詞] (與a或the連用)一些
fifteen 		[形容詞] 十五的; [名詞] 十五
fifty 		[形容詞] 五十的; [名詞] 五十
fight 		[動詞] 打架;作戰; [名詞] 打架;戰鬥
fill 		[動詞] 充滿;填充
find 		[動詞] 找到
fine 		[形容詞] 好的
finger 		[名詞] 手指
finish 		[動詞] 完成
fire 		[名詞] 火
first 		[形容詞] 第一的
fish 		[動詞] 釣魚; [名詞] 魚
fisherman 		[名詞] 漁夫
five 		[形容詞] 五的; [名詞] 五
fix 		[動詞] 修理
floor 		[名詞] 地板;樓;室內地上
flower 		[名詞] 花
flute 		[名詞] 橫笛
fly 		[動詞] 飛; [名詞] 蒼蠅
follow 		[動詞] 遵循;跟隨
food 		[名詞] 食物
foot 		[名詞] 腳;一尺長
for 		[介系詞] 為…做的;給; [連接詞] 因為,由於
foreign 		[形容詞] 外國的
foreigner 		[名詞] 外國人
forget 		[動詞] 忘記
fork 		[名詞] 叉子
forty 		[形容詞] 四十的; [名詞] 四十
four 		[形容詞] 四的; [名詞] 四
fourteen 		[形容詞] 十四的; [名詞] 十四
fox 		[名詞] 狐狸
free 		[形容詞] 空閒的;自由的;免費的
French fries 		[名詞] 薯條
fresh 		[形容詞] 新鮮的
Friday 		[名詞] 星期五
friend 		[名詞] 朋友
friendly 		[形容詞] 友善的
frisbee 		[名詞] (投擲遊戲用的)飛碟;飛盤
frog 		[名詞] 青蛙
from 		[介系詞] 從
front 		[名詞] 前方
fruit 		[名詞] 水果
fry 		[動詞] 油炸; [名詞] 炸薯條
full 		[形容詞] 飽的;滿的
fun 		[名詞] 樂趣
funny 		[形容詞] 可笑的;滑稽的
future 		[名詞] 未來
game 		[名詞] 比賽;遊戲
garbage 		[名詞] 垃圾
garden 		[名詞] 花園
gas 		[名詞] 瓦斯;汽油
gate 		[名詞] 柵門;登機門
get 		[動詞] 得到;拿到
ghost 		[名詞] 鬼
giant 		[形容詞] 巨大的; [名詞] 巨人
gift 		[名詞] 禮物
girl 		[名詞] 女孩
give 		[動詞] 給
glad 		[形容詞] 高興的
glass 		[名詞] 玻璃杯;玻璃
glasses 		[名詞] 眼鏡
glove 		[名詞] 手套
glue 		[動詞] 黏住;緊附; [名詞] 膠;膠水
go 		[動詞] 去;走
goat 		[名詞] 山羊
good 		[形容詞] 好的
goodbye 		[感歎詞] 再見;再會
good-bye 		[感歎詞] 再見;再會; [名詞] 告別
goose 		[名詞] 鵝
grade 		[名詞] 年級;分數
gram 		[名詞] 公克
grandfather 		[名詞] 祖父;外祖父
grandma 		[名詞] 祖母;外祖母
grandmother 		[名詞] 祖母;外祖母
grandpa 		[名詞] 祖父;外祖父
grape 		[名詞] 葡萄
grass 		[名詞] 草
gray 		[形容詞] 灰色的; [名詞] 灰色
great 		[形容詞] 很棒;大的
green 		[形容詞] 綠色的; [名詞] 綠色
ground 		[名詞] 地面
group 		[名詞] 一群
grow 		[動詞] 種植;成長
guava 		[名詞] 番石榴
guess 		[動詞] 猜; [名詞] 猜測
guitar 		[名詞] 吉他
guy 		[名詞] 傢伙;人
gym 		[名詞] 體育館;體育;體操
habit 		[名詞] 習慣
hadn't 		[縮短形] had not
hair 		[名詞] 頭髮
half 		[名詞] 一半
Halloween 		[名詞] 萬聖節
ham 		[名詞] 火腿
hamburger 		[名詞] 漢堡
hand 		[動詞] 面交,給,傳遞; [名詞] 手
handsome 		[形容詞] 英俊的
hang 		[動詞] 把…掛起;吊
happen 		[動詞] 發生
happy 		[形容詞] 快樂的
hard 		[形容詞] 硬的;難的; [副詞] 辛苦地
hard-working 		[形容詞] 勤勉的
hasn't 		[縮短形] has not
hat 		[名詞] 帽子
hate 		[動詞] 憎恨
have 		[動詞] 有; [助動詞] 已經
haven't 		[縮短形] have not
he 		[代名詞] 他
head 		[名詞] 頭;首長
headache 		[名詞] 頭痛
health 		[名詞] 健康
healthy 		[形容詞] 健康的
hear 		[動詞] 聽見
heart 		[名詞] 心臟
heat 		[名詞] 熱氣
heavy 		[形容詞] 重的
he'd 		[縮短形] he had; he would
he'll 		[縮短形] he will
hello 		[感歎詞] 哈囉
help 		[動詞] 幫忙
helpful 		[形容詞] 有益的
hen 		[名詞] 母雞
her 		[代名詞] (受格) 她; (所有格) 她的
here 		[副詞] 在這裡
hers 		[代名詞] (所有格) 她的(東西)
herself 		[代名詞] (反身代名詞) 她自己
he's 		[縮短形] he is; he has
hey 		[感歎詞] 嗨;喂
hi 		[感歎詞] 嗨
hide 		[動詞] 躲;隱藏
high 		[形容詞] 高的
hike 		[動詞] 徒步旅行; [名詞] 徒步旅行
hill 		[名詞] 丘陵
him 		[代名詞] (受格) 他
himself 		[代名詞] (反身代名詞) 他自己
hippo 		[名詞] 河馬
his 		[代名詞] (所有格) 他的; 他的(東西)
history 		[名詞] 歷史
hit 		[動詞] 打;擊
hobby 		[名詞] 嗜好
hold 		[動詞] 拿著
holiday 		[名詞] 假日
home 		[名詞] 家
homework 		[名詞] 家庭作業
honest 		[形容詞] 誠實的
honey 		[名詞] 蜂蜜;心愛的人
hop 		[動詞] 單足跳
hope 		[動詞] 希望
horse 		[名詞] 馬
hospital 		[名詞] 醫院
hot 		[形容詞] 熱的
hot dog 		[名詞] 熱狗
hotel 		[名詞] 旅館
hour 		[名詞] 小時
house 		[名詞] 房子
housewife 		[名詞] 家庭主婦
how 		[副詞] 如何
however 		[連接詞] 然而;不過
how's 		[縮短形] how is
hundred 		[形容詞] 一百的; [名詞] 一百
hungry 		[形容詞] 飢餓的
hunt 		[動詞] 追獵
hurry 		[動詞] 趕快; [名詞] 匆忙
hurt 		[動詞] 傷害;使疼痛
husband 		[名詞] 丈夫
I 		[代名詞] 我
ice 		[名詞] 冰
ice cream 		[名詞] 冰淇淋
I'd 		[縮短形] I had; I would
idea 		[名詞] 主意
if 		[連接詞] 如果
I'll 		[縮短形] I shall, I will
I'm 		[縮短形] I am
important 		[形容詞] 重要的
in 		[介系詞] 在…之內
inch 		[名詞] 英吋
insect 		[名詞] 昆蟲
inside 		[介系詞] 在…裡面
interest 		[名詞] 興趣
interested 		[形容詞] 感興趣的
interesting 		[形容詞] 有趣的
Internet 		[名詞] 網際網路
interview 		[動詞] 面談;採訪; [名詞] 面談;採訪
into 		[介系詞] 進入
invite 		[動詞] 邀請
is 		[動詞] 是,在; be 動詞第三人稱,單數,現在式
island 		[名詞] 島嶼
isn't 		[縮短形] is not
it 		[代名詞] 它
it'll 		[縮短形] it will
its 		[代名詞] (所有格) 它的
it's 		[縮短形] it is; it has
itself 		[代名詞] (反身代名詞) 它自己
I've 		[縮短形] I have
jacket 		[名詞] 夾克;外套
January 		[名詞] 一月
jeans 		[名詞] 牛仔褲
job 		[名詞] 職業;工作
jog 		[動詞] 慢跑
join 		[動詞] 加入
joy 		[名詞] 歡喜;樂趣
juice 		[名詞] 果汁
July 		[名詞] 七月
jump 		[動詞] 跳躍
June 		[名詞] 六月
junior high school 		[片語] 初級中學
just 		[副詞] 正好;剛才
kangaroo 		[名詞] 袋鼠
keep 		[動詞] 保留;保持
key 		[名詞] 鑰匙
kick 		[動詞] 踢
kid 		[動詞] 戲弄; [名詞] 小孩
kill 		[動詞] 殺
kilogram 		[名詞] 公斤
kind 		[形容詞] 仁慈的; [名詞] 種類
king 		[名詞] 國王
kiss 		[動詞] 親吻; [名詞] 吻
kitchen 		[名詞] 廚房
kite 		[名詞] 風箏
knee 		[名詞] 膝蓋
knife 		[名詞] 刀子
knock 		[動詞] 敲
know 		[動詞] 知道
knowledge 		[名詞] 學問;知識
koala 		[名詞] 澳洲產無尾熊
lake 		[名詞] 湖
lamp 		[名詞] 燈
land 		[動詞] 登陸; [名詞] 陸地
language 		[名詞] 語言
lantern 		[名詞] 燈籠
large 		[形容詞] 大的
last 		[形容詞] 最後的; [動詞] 持續; [副詞] 最後地
late 		[形容詞] 晚的;遲的
laugh 		[動詞] 笑
lawyer 		[名詞] 律師
lazy 		[形容詞] 懶惰的
lead 		[動詞] 引導
leader 		[名詞] 領袖
learn 		[動詞] 學習
least 		[名詞] 最少
leave 		[動詞] 離開;丟下
left 		[形容詞] 左邊的
leg 		[名詞] 腿
lemon 		[名詞] 檸檬
lend 		[動詞] 出借
less 		[形容詞] 較少的
lesson 		[名詞] 課;教訓
let 		[動詞] 讓
let's 		[縮短形] let us
letter 		[名詞] 信;字母
lettuce 		[名詞] 類似萵苣的生菜
library 		[名詞] 圖書館
lid 		[名詞] 蓋子
lie 		[動詞] 說謊;躺; [名詞] 謊言
life 		[名詞] 人生;生命
light 		[形容詞] 輕的; [名詞] 光線;燈
like 		[動詞] 喜歡; [介系詞] 像;如
line 		[動詞] 排隊; [名詞] 線;隊伍
lion 		[名詞] 獅子
lip 		[名詞] 嘴唇
list 		[動詞] 列成表; [名詞] 單子
listen 		[動詞] 傾聽
little 		[形容詞] 很少的; [副詞] 一點點
live 		[動詞] 居住
living room 		[名詞] 客廳
lonely 		[形容詞] 寂寞的
long 		[形容詞] 長的
look 		[動詞] 看
lose 		[動詞] 輸;失去
lot 		[名詞] 很多,多數;一批;一塊地
loud 		[形容詞] 大聲的
love 		[動詞] 愛好,喜歡; [名詞] 愛
lovely 		[形容詞] 動人的
low 		[形容詞] 低的;矮的
lucky 		[形容詞] 幸運的
lunch 		[名詞] 午餐
machine 		[名詞] 機器
mad 		[形容詞] 發火;發瘋;發狂的
magic 		[形容詞] 不可思議的;有魔力的; [名詞] 魔術
mail 		[動詞] 寄信; [名詞] 信件
mailman 		[名詞] 郵差
make 		[動詞] 製造; 使得
man 		[名詞] 男人; 人類
many 		[形容詞] 很多的; [代名詞] 許多
map 		[名詞] 地圖
march 		[名詞] 三月
mark 		[動詞] 做記號; [名詞] 記號
marker 		[名詞] 標誌;白板筆;馬克筆
market 		[名詞] 市場
married 		[形容詞] 已婚的
mask 		[名詞] 面具
mat 		[名詞] 蓆子;墊子
math 		[名詞] 數學
mathematics 		[名詞] 數學
matter 		[名詞] 事情
may 		[助動詞] 可能
maybe 		[副詞] 可能;也許
me 		[代名詞] (受格) 我
meal 		[名詞] 餐
mean 		[形容詞] 兇的;吝嗇的; [動詞] 意指
meat 		[名詞] 肉類
medicine 		[名詞] 藥
medium 		[形容詞] 中等的
meet 		[動詞] 遇見
menu 		[名詞] 菜單
mightn't 		[縮短形] might not
mile 		[名詞] 英哩
milk 		[名詞] 牛奶
million 		[名詞] 百萬
mind 		[動詞] 介意; [名詞] 心智
mine 		[代名詞] (所有格) 我的(東西)
minute 		[名詞] 分鐘
miss 		[動詞] 想念;惦記;未達到; [名詞] 少女
mistake 		[名詞] 錯誤
modern 		[形容詞] 現代的
mom 		[名詞] 母親
moment 		[名詞] 片刻
mommy 		[名詞] 母親
Monday 		[名詞] 星期一
money 		[名詞] 錢
monkey 		[名詞] 猴子
month 		[名詞] 月份
moon 		[名詞] 月亮
mop 		[動詞] 拖洗;擦去; [名詞] 拖把
more 		[名詞] 更多的數量
morning 		[名詞] 早晨
most 		[代名詞] 大部分
mother 		[名詞] 母親
motorcycle 		[名詞] 機車
mountain 		[名詞] 山
mouse 		[名詞] 老鼠; 滑鼠
mouth 		[名詞] 嘴巴
move 		[動詞] 移動
movie 		[名詞] 電影
Mr. 		[縮寫] 先生
Mrs. 		[縮寫] 女士;太太
MRT 		[縮寫] 大眾捷運系統
Ms. 		[縮寫] 女士或小姐
much 		[形容詞] 很多的
mud 		[名詞] 泥巴
museum 		[名詞] 博物館
music 		[名詞] 音樂
must 		[助動詞] 必須
mustn't 		[縮短形] must not
my 		[代名詞] (所有格) 我的
myself 		[代名詞] (反身代名詞) 我自己
nail 		[名詞] 釘子;指甲
name 		[動詞] 給...取名;列舉; [名詞] 名字
national 		[形容詞] 國家的
nature 		[名詞] 自然
near 		[形容詞] 近的; [副詞] 近地; [介系詞] 接近
neck 		[名詞] 脖子
need 		[動詞] 需要; [助動詞] (用於疑問句和否定句)需要,必須
neighbor 		[名詞] 鄰居
never 		[副詞] 永不
new 		[形容詞] 新的
news 		[名詞] 新聞
newspaper 		[名詞] 報紙
next 		[形容詞] 下一個
nice 		[形容詞] 好的
night 		[名詞] 夜晚
nine 		[形容詞] 九的; [名詞] 九
nineteen 		[形容詞] 十九的; [名詞] 十九
ninety 		[形容詞] 九十的; [名詞] 九十
no 		[形容詞] 沒有;不; [副詞] 不
nobody 		[名詞] 無名小子; [代名詞] 無人
nobody's 		[縮短形] nobody is; nobody has
nod 		[動詞] 點頭; [名詞] 點頭
noise 		[名詞] 噪音
noodle 		[名詞] 麵
noon 		[名詞] 中午
north 		[形容詞] 北方的; [副詞] 向北方; [名詞] 北方
nose 		[名詞] 鼻子
not 		[副詞] 不
note 		[動詞] 注意;記下; [名詞] 筆記;音符;記錄
notebook 		[名詞] 筆記本
nothing 		[代名詞] 無事;無物
notice 		[動詞] 注意到;通知; [名詞] 注意;通知
November 		[名詞] 十一月
now 		[副詞] 現在
number 		[名詞] 號碼;數字
nurse 		[名詞] 護士
o'clock 		[名詞] 點鐘
October 		[名詞] 十月
of 		[介系詞] …的(所有)
off 		[副詞] 脫下; [介系詞] 離去
office 		[名詞] 辦公室
officer 		[名詞] 軍官;官員
often 		[副詞] 常常
oil 		[名詞] 油
OK 		[形容詞] 好吧
old 		[形容詞] 年老的
on 		[介系詞] 在…上面
once 		[副詞] 一次
one 		[形容詞] 一個的; [名詞] 一;一個人;一件事物
only 		[副詞] 只,僅僅,才;不料;反而; [連接詞] 可是,不過;要不是,若非
open 		[動詞] 打開
or 		[連接詞] 或
orange 		[形容詞] 橙色的; [名詞] 柳橙;橙色
order 		[動詞] 點菜;訂購; [名詞] 定單
other 		[形容詞] 其他的; [代名詞] 其他的人或物
our 		[代名詞] 我們的 (所有格)
ours 		[代名詞] (所有格) 我們的(東西)
ourselves 		[代名詞] (反身代名詞) 我們自己
out 		[形容詞] 在外的; [副詞] 在外地; [介系詞] 通過...而出
outside 		[副詞] 外面地; [介系詞] 在外
over 		[形容詞] 結束了; [介系詞] 在…之上
own 		[形容詞] 自己的; [動詞] 擁有
ox 		[名詞] 公牛
P.M. 		[縮寫] 下午
pack 		[動詞] 包裝; [名詞] 一小包
package 		[名詞] 包裹
page 		[名詞] 頁
paint 		[動詞] 畫圖;油漆
pair 		[名詞] 一副
pants 		[名詞] 褲子
papaya 		[名詞] 木瓜
paper 		[名詞] 紙張
parent 		[名詞] 雙親之一
park 		[動詞] 停放車輛; 放置; [名詞] 公園
part 		[名詞] 部份
party 		[名詞] 派對
pass 		[動詞] 及格;經過;超過;傳遞
past 		[形容詞] 過去的; [介系詞] 走過
paste 		[動詞] 黏貼; [名詞] 漿糊
pay 		[動詞] 付錢
PE 		[縮寫] 體育 (physical education)
peach 		[名詞] 桃子
pear 		[名詞] 梨子
pen 		[名詞] 原子筆;墨水筆
pencil 		[名詞] 鉛筆
people 		[名詞] 人們
perhaps 		[副詞] 或許;可能
person 		[名詞] 人
pet 		[名詞] 寵物
phone 		[名詞] 電話
photo 		[名詞] 相片
piano 		[名詞] 鋼琴
pick 		[動詞] 採收;撿起;選
picnic 		[名詞] 野餐
picture 		[名詞] 圖畫;照片
pie 		[名詞] 派(食品)
piece 		[名詞] 件;片
pig 		[名詞] 豬
pin 		[名詞] 大頭針;胸針
pink 		[形容詞] 粉紅色的; [名詞] 粉紅色
pipe 		[名詞] 管子
pizza 		[名詞] 披薩
place 		[名詞] 地方
plan 		[動詞] 計劃; [名詞] 計畫
plane 		[名詞] 飛機
planet 		[名詞] 行星
plant 		[動詞] 栽種;播種; [名詞] 植物,農作物;工廠
plate 		[名詞] 盤;碟
play 		[動詞] 玩; [名詞] 遊戲;戲劇
player 		[名詞] 遊戲者;運動者;表演者
playground 		[名詞] 遊樂場;運動場
please 		[動詞] 請;取悅
pleasure 		[名詞] 愉快
pocket 		[名詞] 口袋
point 		[名詞] 點;要點
police 		[名詞] 警察
polite 		[形容詞] 有禮貌的
pond 		[名詞] 池塘
pool 		[名詞] 水池;美式撞球
poor 		[形容詞] 貧窮的
popcorn 		[名詞] 爆米花
popular 		[形容詞] 流行的;受歡迎的
pork 		[名詞] 豬肉
possible 		[形容詞] 可能的
post office 		[名詞] 郵局
postcard 		[名詞] 明信片
pot 		[名詞] 罐;鍋
pound 		[名詞] 磅
power 		[名詞] 權力;動力
practice 		[動詞] 練習;訓練; [名詞] 練習
pray 		[動詞] 禱告
prepare 		[動詞] 準備
present 		[動詞] 提出; [名詞] 禮物
pretty 		[形容詞] 漂亮的; [副詞] 十分地
price 		[名詞] 價錢
prince 		[名詞] 王子
princess 		[名詞] 公主
prize 		[名詞] 獎品
problem 		[名詞] 問題
program 		[名詞] 節目
proud 		[形容詞] 感光榮的;驕傲的
public 		[形容詞] 公開的;公立的
pull 		[動詞] 拉
pumpkin 		[名詞] 南瓜
puppy 		[名詞] 小狗
purple 		[形容詞] 紫色的; [名詞] 紫色
push 		[動詞] 推開
put 		[動詞] 放置
quarter 		[名詞] ¼;美金25分;15分鐘
queen 		[名詞] 皇后
question 		[動詞] 詢問; [名詞] 問題
quick 		[形容詞] 快的
quiet 		[形容詞] 安靜的
quite 		[副詞] 完全地;相當
quiz 		[名詞] 小考
rabbit 		[名詞] 兔子
race 		[動詞] 與...賽跑; [名詞] 競賽;(生物的)種類
radio 		[名詞] 收音機
railway 		[名詞] 鐵路
rain 		[動詞] 下雨; [名詞] 雨
rainbow 		[名詞] 彩虹
rainy 		[形容詞] 下雨的;多雨的
raise 		[動詞] 舉起;提高
rat 		[名詞] 老鼠
read 		[動詞] 閱讀
ready 		[形容詞] 準備好的
real 		[形容詞] 真實的
recorder 		[名詞] 錄影機;錄音機
red 		[形容詞] 紅色的; [名詞] 紅色
refrigerator 		[名詞] 電冰箱
remember 		[動詞] 記得
repeat 		[動詞] 重複
reporter 		[名詞] 記者
rest 		[動詞] 休息
restaurant 		[名詞] 餐廳
restroom 		[名詞] 廁所
rice 		[名詞] 稻米;飯
rich 		[形容詞] 富有的
ride 		[動詞] 騎;乘; [名詞] 搭乘;兜風
right 		[形容詞] 右邊;對的; [副詞] 向右地;馬上; [名詞] 公理;權利
ring 		[動詞] (鐘,鈴等)鳴,響; [名詞] 指環;鈴聲
rise 		[動詞] 起身;升起
river 		[名詞] 河流
road 		[名詞] 道路
robot 		[名詞] 機器人
ROC 		[名詞] 中華民國
rock 		[動詞] 搖動; [名詞] 岩石;搖滾樂
roll 		[動詞] 捲;滾
room 		[名詞] 房間
rope 		[名詞] 粗繩
round 		[形容詞] 圓形的
row 		[動詞] 划船; [名詞] 行列
rule 		[動詞] 統治;裁決; [名詞] 規則
ruler 		[名詞] 尺;統治者
run 		[動詞] 跑
sad 		[形容詞] 難過的
safe 		[形容詞] 安全的
sail 		[動詞] 航行
salad 		[名詞] 沙拉
sale 		[名詞] 售賣;賤賣
salesman 		[名詞] 售貨員
salt 		[名詞] 鹽
same 		[形容詞] 相同的
sandwich 		[名詞] 三明治
Saturday 		[名詞] 星期六
save 		[動詞] 救;省;存錢
say 		[動詞] 說
scared 		[形容詞] 害怕的
school 		[名詞] 學校
science 		[名詞] 科學
scooter 		[名詞] 小輪摩托車
screen 		[動詞] 篩選;放映電影; [名詞] 屏;銀幕
sea 		[名詞] 海
season 		[名詞] 季節
seat 		[名詞] 座位
second 		[名詞] 第二;秒
secretary 		[名詞] 秘書
see 		[動詞] 看見
seed 		[名詞] 種子
seesaw 		[名詞] 蹺蹺板
seldom 		[副詞] 很少地
sell 		[動詞] 賣
send 		[動詞] 寄發;送
senior high school 		[片語] 高級中學
sentence 		[動詞] 宣判;判決; [名詞] 句子
September 		[名詞] 九月
serious 		[形容詞] 嚴肅的;嚴重的;認真的
set 		[動詞] 安放;沒入; [名詞] 套;組
seven 		[形容詞] 七的; [名詞] 七
seventeen 		[形容詞] 十七的; [名詞] 十七
seventy 		[形容詞] 七十的; [名詞] 七十
several 		[形容詞] 幾個的
shake 		[動詞] 搖動;握(手); [名詞] 搖動;奶昔
shall 		[助動詞] 將;應該
shape 		[名詞] 形狀
share 		[動詞] 分享
shark 		[名詞] 鯊魚
sharp 		[形容詞] 尖銳的;敏銳的
she 		[代名詞] 她
she'd 		[縮短形] she had; she would
sheep 		[名詞] 綿羊
she'll 		[縮短形] she will
she's 		[縮短形] she is; she has
shine 		[動詞] 照耀
ship 		[名詞] 船
shirt 		[名詞] 襯衫
shoe 		[名詞] 鞋子
shop 		[動詞] 購物; [名詞] 商店
shopkeeper 		[名詞] 小店主
short 		[形容詞] 矮的;短的
shorts 		[名詞] 短褲
should 		[助動詞] 將;萬一,竟然;該
shoulder 		[名詞] 肩膀
shouldn't 		[縮短形] should not
shout 		[動詞] 呼叫
show 		[動詞] 表演;顯示; [名詞] 展覽;電影
shy 		[形容詞] 害羞的
sick 		[形容詞] 生病的
side 		[形容詞] 側面的; [名詞] 邊
sidewalk 		[名詞] 路邊行人道
sight 		[名詞] 視力;景象
sign 		[動詞] 簽字;做信號; [名詞] 記號
simple 		[形容詞] 簡單的
since 		[介系詞] 由於;自從...之後; [連接詞] 自...以來;因為
sing 		[動詞] 唱歌
singer 		[名詞] 歌手
sir 		[名詞] 先生
sister 		[名詞] 姊妹
sit 		[動詞] 坐
six 		[形容詞] 六的; [名詞] 六
sixteen 		[形容詞] 十六的; [名詞] 十六
sixty 		[形容詞] 六十的; [名詞] 六十
size 		[名詞] 大小;尺寸
skate 		[動詞] 溜冰; [名詞] 冰鞋
skirt 		[名詞] 裙子
sky 		[名詞] 天空
sleep 		[動詞] 睡覺
slide 		[動詞] 滑壘滑動; [名詞] 滑梯;土崩
slim 		[形容詞] 細長的;微小的
slow 		[形容詞] 緩慢的
small 		[形容詞] 小的
smart 		[形容詞] 聰明的
smell 		[動詞] 聞
smile 		[動詞] 微笑; [名詞] 微笑
smoke 		[動詞] 抽煙;冒煙; [名詞] 煙
snack 		[名詞] 點心
snake 		[名詞] 蛇
snow 		[動詞] 下雪; [名詞] 雪
snowman 		[名詞] 雪人
snowy 		[形容詞] 似雪的;多雪的
so 		[副詞] 這麼;也如此; [連接詞] 因此
soccer 		[名詞] 足球
socks 		[名詞] 一雙襪子
sofa 		[名詞] 沙發
soldier 		[名詞] 軍人
some 		[形容詞] 一些的; [代名詞] 一些
somebody 		[代名詞] 某人
somebody's 		[縮短形] somebody is; somebody has
someone 		[代名詞] 某人
something 		[代名詞] 某事
sometimes 		[副詞] 有時候
somewhere 		[副詞] 在某處
son 		[名詞] 兒子
song 		[名詞] 歌曲
soon 		[副詞] 即刻;不久
sore 		[形容詞] 疼痛的
sorry 		[形容詞] 抱歉;遺憾的; [感歎詞] 對不起
sound 		[動詞] 聽起來; [名詞] 聲音
soup 		[名詞] 湯
south 		[形容詞] 南方的; [副詞] 向南方; [名詞] 南方
space 		[名詞] 空位;太空
spaghetti 		[名詞] 義大利麵條
speak 		[動詞] 說;講
special 		[形容詞] 特別的
spell 		[動詞] 拼字
spend 		[動詞] 花費(錢或時間)
spider 		[名詞] 蜘蛛
spoon 		[名詞] 湯匙
sports 		[形容詞] 運動的
spring 		[名詞] 春天;泉
square 		[形容詞] 正方形的; [名詞] 正方形
stairs 		[名詞] 樓梯
stamp 		[動詞] 頓足;蓋印; [名詞] 郵票;印章
stand 		[動詞] 站住; 堅持; 面對; 承擔...任務; [名詞] 攤子;停止,站立； 立場;態度
star 		[名詞] 星星;明星
start 		[動詞] 開始
station 		[名詞] 車站;場所
stay 		[動詞] 停留
steak 		[名詞] 牛排
still 		[形容詞] 靜止的; [副詞] 仍然
stomach 		[名詞] 胃
stop 		[動詞] 停止; [名詞] 車站
store 		[名詞] 商店
story 		[名詞] 故事;樓層
straight 		[形容詞] 直的
strange 		[形容詞] 奇怪的
straw 		[名詞] 稻草;吸管
strawberry 		[名詞] 草莓
street 		[名詞] 街道
strong 		[形容詞] 強壯的
student 		[名詞] 學生
study 		[動詞] 學習;讀書; [名詞] 書房
stupid 		[形容詞] 笨的
subject 		[名詞] 主題;學科
successful 		[形容詞] 成功的
sugar 		[名詞] 糖
summer 		[名詞] 夏天
sun 		[名詞] 太陽
Sunday 		[名詞] 星期日
sunny 		[形容詞] 晴朗的
supermarket 		[名詞] 超級市場
sure 		[形容詞] 確定
surf 		[動詞] 衝浪;在網路或頻道上搜索資料; [名詞] 海浪
surprise 		[動詞] 使驚奇; [名詞] 意外之事物
surprised 		[形容詞] 驚訝的
sweater 		[名詞] 毛衣
sweet 		[形容詞] 甜的
swim 		[動詞] 游泳
swing 		[動詞] 搖擺;揮動; [名詞] 鞦韆;搖擺音樂
table 		[名詞] 桌子
tail 		[名詞] 尾巴
Taiwan 		[名詞] 台灣
take 		[動詞] 拿;帶;採用
talk 		[動詞] 講話
tall 		[形容詞] 高的
tape 		[名詞] 錄音帶;錄影帶;膠帶
taste 		[動詞] 嘗
taxi 		[名詞] 計程車
tea 		[名詞] 茶
teach 		[動詞] 教
teacher 		[名詞] 老師
team 		[名詞] 隊
teenager 		[名詞] 十幾歲孩子
telephone 		[名詞] 電話
television 		[名詞] 電視
tell 		[動詞] 告訴
temple 		[名詞] 廟宇;神殿
ten 		[形容詞] 十的; [名詞] 十
tennis 		[名詞] 網球
terrible 		[形容詞] 可怕的
test 		[動詞] 試驗;測驗; [名詞] 測驗;考試
than 		[介系詞] 超過; [連接詞] 比較
thank 		[動詞] 感謝
that 		[形容詞] 那;那個; [連接詞] 以致; [代名詞] 那人;那事
that's 		[縮短形] that is
the 		[冠詞] 這
theater 		[名詞] 戲院;劇院
their 		[代名詞] (所有格) 他們的
theirs 		[代名詞] (所有格) 他們的(東西)
them 		[代名詞] (受格) 他們
themselves 		[代名詞] (反身代名詞) 他(她,它)們自己
then 		[副詞] 當時;之後;那麼
there 		[副詞] 在那裡
there's 		[縮短形] there is; there has
these 		[代名詞] 這些
they 		[代名詞] 他們
they'd 		[縮短形] they would
they'll 		[縮短形] they will
they're 		[縮短形] they are
they've 		[縮短形] they have
thick 		[形容詞] 粗的;厚的
thin 		[形容詞] 瘦的
thing 		[名詞] 事物;東西
think 		[動詞] 想
third 		[形容詞] 第三
thirsty 		[形容詞] 口渴的
thirteen 		[形容詞] 十三的; [名詞] 十三
thirty 		[形容詞] 三十的; [名詞] 三十
this 		[形容詞] 這; [代名詞] 這個;這人;這事
those 		[代名詞] 那些
though 		[連接詞] 雖然
thousand 		[形容詞] 千的; [名詞] 千
three 		[形容詞] 三的; [名詞] 三
throat 		[名詞] 喉嚨
throw 		[動詞] 投;拋
Thursday 		[名詞] 星期四
ticket 		[名詞] 票;罰單
tidy 		[形容詞] 整潔的; [動詞] 使整潔
tie 		[動詞] 綁;繫; [名詞] 結;領帶;平手
tiger 		[名詞] 老虎
time 		[名詞] 時間;次數
tired 		[形容詞] 疲倦的
to 		[介系詞] 到;向
toast 		[動詞] 烤;乾杯; [名詞] 烤麵包片
today 		[副詞] 今天; [名詞] 今天
toe 		[名詞] 腳趾
together 		[副詞] 一同
tomato 		[名詞] 番茄
tomorrow 		[副詞] 明天; [名詞] 明天
tonight 		[副詞] 今夜;今晚; [名詞] 今夜;今晚
too 		[副詞] 也是;過於
tool 		[名詞] 工具
tooth 		[名詞] 牙齒
top 		[形容詞] 最高的; [名詞] 頂部; 陀螺
total 		[形容詞] 總的; [名詞] 總額
touch 		[動詞] 觸摸
towel 		[名詞] 毛巾
town 		[名詞] 城市
toy 		[名詞] 玩具
traffic 		[名詞] 交通
train 		[名詞] 火車
trash 		[名詞] 垃圾
treat 		[動詞] 對待;治療; [名詞] 款待
tree 		[名詞] 樹木
trick 		[動詞] 欺騙; [名詞] 詭計;戲法;惡作劇
trip 		[名詞] 旅行
trouble 		[名詞] 麻煩
truck 		[名詞] 卡車
true 		[形容詞] 真實的;正確的
try 		[動詞] 試做
T-shirt 		[名詞] 短袖圓領運動衫
tub 		[名詞] 浴缸
Tuesday 		[名詞] 星期二
turkey 		[名詞] 火雞
turn 		[動詞] 轉; [名詞] 輪到
turtle 		[名詞] 烏龜
TV 		[縮寫] 電視
twelve 		[形容詞] 十二的; [名詞] 十二
twenty 		[形容詞] 二十的; [名詞] 二十
twice 		[副詞] 兩次
two 		[形容詞] 二的; [名詞] 二
type 		[動詞] 打字; [名詞] 類型
typhoon 		[名詞] 颱風
umbrella 		[名詞] 雨傘
uncle 		[名詞] 叔叔
under 		[介系詞] 在…下面
understand 		[動詞] 了解
unhappy 		[形容詞] 不快樂的
uniform 		[名詞] 制服
until 		[介系詞] 直到
up 		[副詞] 向上; [介系詞] 向...上
us 		[代名詞] 我們 (受格)
USA 		[縮寫] 美國 (United States of America)
use 		[動詞] 利用; [名詞] 用途
useful 		[形容詞] 有用的
vacation 		[名詞] 假期
vegetable 		[名詞] 蔬菜
very 		[副詞] 很;非常
vest 		[名詞] 背心
video 		[名詞] 錄影機;錄影帶
violin 		[名詞] 小提琴
visit 		[動詞] 訪問; [名詞] 訪問
voice 		[名詞] (人的)聲音
wait 		[動詞] 等候
waiter 		[名詞] 男服務生
waitress 		[名詞] 女服務生
wake 		[動詞] 叫醒
walk 		[動詞] 走路
wall 		[名詞] 牆
wallet 		[名詞] 皮夾
want 		[動詞] 想要
warm 		[形容詞] 溫暖的; [動詞] 使暖和
wash 		[動詞] 洗
wasn't 		[縮短形] was not
watch 		[動詞] 注意看; [名詞] 手錶
water 		[名詞] 水
watermelon 		[名詞] 西瓜
wave 		[動詞] 揮動; [名詞] 波浪
way 		[名詞] 方法;路
we 		[代名詞] 我們
weak 		[形容詞] 虛弱的
wear 		[動詞] 穿著
weather 		[名詞] 天氣
we'd 		[縮短形] we would
Wednesday 		[名詞] 星期三
week 		[名詞] 星期
weekend 		[名詞] 周末
welcome 		[動詞] 歡迎
well 		[形容詞] 健康的; [副詞] 很好地;充分地; [感歎詞] 啊;那麼
we'll 		[縮短形] we will
we're 		[縮短形] we are
weren't 		[縮短形] were not
west 		[形容詞] 西方的; [副詞] 向西方; [名詞] 西方
wet 		[形容詞] 潮溼的
we've 		[縮短形] we have
whale 		[名詞] 鯨魚
what 		[代名詞] 什麼
what's 		[縮短形] what is
when 		[副詞] 何時
when's 		[縮短形] when is
where 		[副詞] 在哪兒
where's 		[縮短形] where is
whether 		[連接詞] 是否
which 		[代名詞] 哪一個
white 		[形容詞] 白色的; [名詞] 白色
who 		[代名詞] 誰
who'd 		[縮短形] who had; who would
who's 		[縮短形] who is; who has
whose 		[代名詞] 誰的
why 		[副詞] 為什麼
wife 		[名詞] 妻子
will 		[助動詞] 將
win 		[動詞] 贏得
wind 		[名詞] 風
window 		[名詞] 窗戶
windy 		[形容詞] 多風的
winter 		[名詞] 冬天
wise 		[形容詞] 有智慧的
wish 		[動詞] 祝福
with 		[介系詞] 跟...在一起;有
without 		[介系詞] 沒有
woman 		[名詞] 女人
wonderful 		[形容詞] 很棒的;奇妙的
won't 		[縮短形] will not
word 		[名詞] 字
work 		[動詞] 工作; [名詞] 工作,作品
workbook 		[名詞] 作業簿
worker 		[名詞] 工人
world 		[名詞] 世界
worry 		[動詞] 擔心
wouldn't 		[縮短形] would not
write 		[動詞] 寫
writer 		[名詞] 作家
wrong 		[形容詞] 錯誤的
yard 		[名詞] 庭院;碼(3英呎)
yeah 		[副詞] 是
year 		[名詞] 年
yellow 		[形容詞] 黃色的; [名詞] 黃色
yes 		[副詞] 是
yesterday 		[形容詞] 昨天; [副詞] 昨天
yet 		[副詞] 尚未;但是; [連接詞] 然而
you 		[代名詞] 你;你們
you'd 		[縮短形] you had; you would
you'll 		[縮短形] you will
young 		[形容詞] 年輕的
your 		[代名詞] (所有格) 你的;你們的
you're 		[縮短形] you are
yours 		[代名詞] (所有格) 你的(東西);你們的(東西)
yourself 		[代名詞] (反身代名詞) 你自己
yourselves 		[代名詞] (反身代名詞) 你們自己
you've 		[縮短形] you have
yummy 		[形容詞] 好吃的
zebra 		[名詞] 斑馬
zero 		[形容詞] 零的; [名詞] 零
zoo 		[名詞] 動物園
